state,year,gas_generation,gas_consumption,coal_generation,coal_consumption,oil_generation,oil_consumption,nuclear_generation,nuclear_consumption,non_renewable_gen,non_renewable_consumption,renewable_generation,renewable_consumption,expenditures (M dollars),price (dollars per MBtu),all_generation,all_consumption
AK,2001,553301,413049,23618,15911,2038184,289334,0,0,2615103,718294,16974,17446,2785.1,8.18,2632077,735740
AL,2001,391253,344004,469962,842337,54137,534772,317019,317019,1232371,2038132,251523,252841,11697.8,9.45,1483894,2290973
AR,2001,170142,231590,381,273982,44034,353382,154356,154356,368913,1013310,94001,94022,7323.7,10.2,462914,1107332
AZ,2001,312,244424,293303,424023,342,514052,299966,299966,593923,1482465,90513,92536,10673.9,12.82,684436,1575001
CA,2001,408873,2513856,0,67839,1511845,3585715,346911,346911,2267629,6514321,607988,615198,73085.8,13,2875617,7129519
CO,2001,873450,464062,741186,400028,95816,453248,0,0,1710452,1317338,23726,30471,9970.1,10.72,1734178,1347809
CT,2001,0,149344,0,39991,0,418855,161112,161112,161112,769302,29813,29919,7949.7,13.49,190925,799221
DC,2001,0,30577,0,741,0,33414,0,0,0,64732,866,866,1519.1,15.21,866,65598
DE,2001,0,51817,0,38335,0,138478,0,0,0,228630,1324,1325,1958.6,11.24,1324,229955
FL,2001,7855,569757,0,725890,25671,1941855,329825,329825,363351,3567327,158039,158138,31485.3,12.62,521390,3725465
GA,2001,0,362643,0,772021,0,1011020,351739,351739,351739,2497423,192060,192068,19424.2,10.23,543799,2689491
HI,2001,0,134,0,17774,0,239817,0,0,0,257725,12389,12395,2779.2,15.34,12389,270120
IA,2001,0,193445,0,443921,0,381227,40234,40234,40234,1058827,105614,76705,8185,10.21,145848,1135532
ID,2001,0,81804,0,11395,0,155395,0,0,0,248594,105045,104604,3183.1,9.78,105045,353198
IL,2001,239,958425,772290,983729,58534,1230341,964500,964500,1795563,4136995,113176,100875,29125.5,11.1,1908739,4237870
IN,2001,1090,505274,813161,1569235,11728,801895,0,0,825979,2876404,49614,53158,16979.8,8.82,875593,2929562
KS,2001,544550,273862,3697,354647,196864,377245,108050,108050,853161,1113804,13084,10929,7051.1,10.71,866245,1124733
KY,2001,86962,216705,3326940,1013055,17220,627963,0,0,3431122,1857723,53193,53539,10503.9,9.3,3484315,1911262
LA,2001,1791678,1347228,50817,239990,606738,1965937,181041,181041,2630274,3734196,136086,136129,20720.1,7.93,2766360,3870325
MA,2001,0,364097,0,109014,0,739924,53719,53719,53719,1266754,47997,48003,15797.9,14.3,101716,1314757
MD,2001,33,184783,111689,318851,0,566433,142612,142612,254334,1212679,33247,33276,11221.2,11.86,287581,1245955
ME,2001,0,101190,0,7875,0,227875,0,0,0,336940,146146,146148,3573.5,10.18,146146,483088
MI,2001,288366,924496,0,789703,42775,980720,278941,278941,610082,2973860,94158,99025,21789.6,9.94,704240,3072885
MN,2001,0,344882,0,353305,0,652093,123113,123113,123113,1473393,108950,108048,12421,10.42,232063,1581441
MO,2001,0,288586,8022,716378,528,722516,87557,87557,96107,1815037,32926,33141,13806.8,11.04,129033,1848178
MS,2001,135437,340904,6804,198275,113262,479661,103635,103635,359138,1122475,56085,56103,7569.8,10.37,415223,1178578
MT,2001,83918,66483,708173,184401,92336,156398,0,0,884427,407282,80568,80654,2472.1,10.66,964995,487936
NC,2001,0,215600,0,756311,0,900456,394485,394485,394485,2266852,127348,131872,18889.1,11.67,521833,2398724
ND,2001,68363,57334,398430,420001,183808,137162,0,0,650601,614497,20662,19505,2169.8,7.28,671263,634002
NE,2001,1229,124051,0,226691,16948,215468,91127,91127,109304,657337,70152,43413,4454.4,10.36,179456,700750
NH,2001,0,24757,0,40125,0,166694,90778,90778,90778,322354,30186,30187,3061.5,13.62,120964,352541
NJ,2001,0,573040,0,112207,0,1193427,318190,318190,318190,2196864,29052,30089,19987.8,11.13,347242,2226953
NM,2001,1813050,259626,554846,297096,394406,238316,0,0,2762302,795038,8027,7911,4229.7,11.39,2770329,802949
NV,2001,7,181256,0,188572,3318,247451,0,0,3325,617279,43411,46005,5234.6,12.97,46736,663284
NY,2001,28593,1204885,0,306993,963,1625732,421845,421845,451401,3559455,350747,351194,39674.6,13.71,802148,3910649
OH,2001,104433,836825,598946,1362828,35096,1257823,161488,161488,899963,3618964,51101,68387,29052.9,10.9,951064,3687351
OK,2001,1801655,505220,42810,376112,397480,581673,0,0,2241945,1463005,48390,48426,9916.9,10.46,2290335,1511431
OR,2001,1139,235634,0,43365,0,352498,0,0,1139,631497,349949,351491,7386.3,10.97,351088,982988
PA,2001,139028,668960,1929615,1392203,9396,1431355,769971,769971,2848010,4262489,95728,97228,29847.8,11.26,2943738,4359717
RI,2001,0,98571,0,50,0,99767,0,0,0,198388,3898,3899,2307.2,14.05,3898,202287
SC,2001,0,147167,0,414459,0,481022,520792,520792,520792,1563440,70574,70578,9937.2,10.4,591366,1634018
SD,2001,1099,37035,0,44372,7279,110286,0,0,8378,191693,41313,41085,1925.8,11.05,49691,232778
TN,2001,2074,265461,84824,687352,2036,710393,298424,298424,387358,1961630,142349,138865,13937,9.99,529707,2100495
TX,2001,5971835,4382935,578696,1492977,2460923,5773604,398535,398535,9409989,12048051,96534,102165,74136.9,8.86,9506523,12150216
UT,2001,316014,167582,640594,384453,88462,260345,0,0,1045070,812380,10816,12128,4542.5,9.27,1055886,824508
VA,2001,74190,246406,863870,487601,64,888633,269003,269003,1207127,1891643,92832,95661,16114.5,10.71,1299959,1987304
VT,2001,0,7909,0,50,0,89212,43559,43559,43559,140730,17341,17342,1637.4,13.9,60900,158072
WA,2001,0,322413,72134,99441,0,768387,86159,86159,158293,1276400,659060,660974,12865.9,10.44,817353,1937374
WI,2001,0,363022,0,494043,0,603696,120168,120168,120168,1580929,121849,128460,13152.9,10.56,242017,1709389
WV,2001,222402,150543,4085483,866590,7111,217958,0,0,4314996,1235091,14725,15165,4302.3,8.81,4329721,1250256
WY,2001,1538857,103990,6407633,499817,333111,156709,0,0,8279601,760516,14909,14658,2342.6,8.51,8294510,775174
US,2001,22584794,22747645,23587925,21906355,12281622,38087631,8028853,8028853,66483194,90770484,5166059,5164253,696242.1,10.78,71649253,95934737
AK,2002,539400,420808,17878,16429,2084416,277400,0,0,2641694,714637,17922,18269,2525.1,7.78,2659616,732906
AL,2002,390053,389965,460201,845999,50089,562366,332650,332650,1232993,2130980,252689,253609,11671.5,9.16,1485682,2384589
AR,2002,166236,247899,314,255242,42062,356282,152024,152024,360636,1011447,108618,108652,6974.5,9.39,469254,1120099
AZ,2002,306,255247,280064,406479,365,526176,322260,322260,602995,1510162,86879,88046,10461.4,12.39,689874,1598208
CA,2002,394973,2318656,0,70010,1495808,3704382,358707,358707,2249488,6451755,676213,684544,69633.5,12.07,2925701,7136299
CO,2002,995996,457708,788220,390480,119028,434502,0,0,1903244,1282690,21082,27044,8786.2,9.6,1924326,1309734
CT,2002,0,181665,0,34206,0,382283,155777,155777,155777,753931,28314,28612,7578.8,13.02,184091,782543
DC,2002,0,33688,0,99,0,33375,0,0,0,67162,880,881,1485.8,14.62,880,68043
DE,2002,0,53782,0,40536,0,134057,0,0,0,228375,1314,1315,2013.3,11.17,1314,229690
FL,2002,4893,708638,0,719670,21077,1892395,351940,351940,377910,3672643,174462,174380,30945.9,12.16,552372,3847023
GA,2002,0,393127,0,807121,0,1006589,324827,324827,324827,2531664,283704,283715,19223.3,9.53,608531,2815379
HI,2002,0,140,0,16618,0,257441,0,0,0,274199,10452,10462,2688.2,14.23,10452,284661
IA,2002,0,194041,0,441534,0,396593,47761,47761,47761,1079929,113940,85207,7738.6,9.36,161701,1165136
ID,2002,0,73482,0,10194,0,160021,0,0,0,243697,113779,113189,3211.3,9.95,113779,356886
IL,2002,250,1051213,758830,986832,64380,1196049,948761,948761,1772221,4182855,140266,111585,26852.3,10.13,1912487,4294440
IN,2002,1319,538368,789153,1547530,11380,852562,0,0,801852,2938460,52532,55332,16409.6,8.19,854384,2993792
KS,2002,522294,307432,4351,391664,193604,361909,94413,94413,814662,1155418,22196,19560,6584.4,9.83,836858,1174978
KY,2002,94052,236124,3098985,950941,15782,683158,0,0,3208819,1870223,62858,65077,10415.5,8.8,3271677,1935300
LA,2002,1650962,1475464,51958,232109,541262,1986027,180702,180702,2424884,3874302,140938,144121,19367.2,7.02,2565822,4018423
MA,2002,0,404456,0,118358,0,711365,60237,60237,60237,1294416,46721,46804,14177.8,12.77,106958,1341220
MD,2002,23,203489,125682,325834,0,544694,126641,126641,252346,1200658,38064,41124,10786.1,11.08,290410,1241782
ME,2002,0,126275,0,8000,0,230101,0,0,0,364376,140385,140389,3643.8,9.85,140385,504765
MI,2002,285789,984715,0,739866,41864,992007,324615,324615,652268,3041203,89210,99500,22114.8,9.95,741478,3140703
MN,2002,0,374171,0,360822,0,650633,142897,142897,142897,1528523,107216,104032,11648.2,9.56,250113,1632555
MO,2002,0,278873,5310,725679,551,723507,87605,87605,93466,1815664,35225,37858,13025.1,10.36,128691,1853522
MS,2002,143130,354550,25966,154339,112352,428283,105041,105041,386489,1042213,49641,49669,7253.6,9.91,436130,1091882
MT,2002,88781,70992,676052,166322,98542,161571,0,0,863375,398885,108642,108732,2280.7,9.28,972017,507617
NC,2002,0,243143,0,770928,0,876330,413784,413784,413784,2304185,125225,130792,18347.3,11.37,539009,2434977
ND,2002,69169,61592,401823,422809,178657,123512,0,0,649649,607913,23405,21759,1924,6.69,673054,629672
NE,2002,1196,121174,0,217939,16136,222228,105696,105696,123028,667037,70412,44226,4197.6,9.63,193440,711263
NH,2002,0,26077,0,39845,0,176568,97054,97054,97054,339544,28896,28898,2972.4,12.81,125950,368442
NJ,2002,0,617094,0,104849,0,1178970,322299,322299,322299,2223212,28692,28790,19107.8,10.59,350991,2252002
NM,2002,1763599,229691,543314,284132,391860,243128,0,0,2698773,756951,8690,8188,3908.6,10.61,2707463,765139
NV,2002,6,181010,0,164775,3207,234506,0,0,3213,580291,39421,42485,5304.6,13.05,42634,622776
NY,2002,37663,1227223,0,280584,951,1560207,413686,413686,452300,3481700,363959,364410,36598,12.7,816259,3846110
OH,2002,107180,862453,507902,1396899,32660,1270998,113451,113451,761193,3643801,38155,55136,27491.8,10.37,799348,3698937
OK,2002,1756481,522530,33899,391379,385242,549321,0,0,2175622,1463230,40915,40973,8811.4,9.51,2216537,1504203
OR,2002,856,206808,0,37751,0,366296,0,0,856,610855,400635,403564,7653.1,11.11,401491,1014419
PA,2002,164591,700472,1734216,1457349,13479,1403563,794521,794521,2706807,4355905,96601,97199,28636,10.81,2803408,4453104
RI,2002,0,89824,0,76,0,98079,0,0,0,187979,3699,3736,2032,12.72,3699,191715
SC,2002,0,190714,0,404455,0,478674,556829,556829,556829,1630672,80639,80645,9972.1,10.03,637468,1711317
SD,2002,1024,41532,0,39957,7041,117665,0,0,8065,199154,55199,52277,1913.1,10.09,63264,251431
TN,2002,2116,263690,81658,655906,1595,737577,287927,287927,373296,1945100,153221,148413,13839.2,9.69,526517,2093513
TX,2002,5844637,4444506,581168,1550325,2353501,5924903,371923,371923,9151229,12291657,121027,123648,68744.5,7.96,9272256,12415305
UT,2002,294974,172366,586926,370551,79872,258213,0,0,961772,801130,10879,11230,4231.7,9.18,972651,812360
VA,2002,79530,266853,793381,482759,145,855088,285549,285549,1158605,1890249,77071,82137,15694.1,10.45,1235676,1972386
VT,2002,0,8399,0,25,0,84489,41378,41378,41378,134291,22714,22715,1562.6,13.8,64092,157006
WA,2002,0,240494,91335,100832,0,736282,94484,94484,185819,1172092,887900,893664,12223.2,10.45,1073719,2065756
WI,2002,0,388007,0,491990,0,600959,129991,129991,129991,1610947,101548,110928,12643.8,10,231539,1721875
WV,2002,218554,155536,3805093,993467,8445,228699,0,0,4032092,1377702,15137,16225,4295.6,8.53,4047229,1393927
WY,2002,1626950,117387,6486135,480360,317846,150160,0,0,8430931,747907,12630,12279,2183.3,8.03,8443561,760186
US,2002,21894284,23513541,22729814,21902852,12160205,38122145,8145429,8145429,64929732,91683967,5730811,5726026,663964.4,10.1,70660543,97409993
AK,2003,562687,415891,16864,12552,2062497,285417,0,0,2642048,713860,19374,19607,2816.7,9.08,2661422,733467
AL,2003,374804,360483,486363,873735,45785,561731,330137,330137,1237089,2126086,283428,284732,12686.9,9.98,1520517,2410818
AR,2003,175384,254571,180,253653,41812,357343,153093,153093,370469,1018660,107905,107933,7534,10.23,478374,1126593
AZ,2003,447,275650,262251,406537,273,537072,297872,297872,560843,1517131,83079,84201,11922.7,13.86,643922,1601332
CA,2003,373822,2317062,0,69469,1438939,3520087,370958,370958,2183719,6277576,719392,768593,78234.1,13.83,2903111,7046169
CO,2003,1078307,436873,801108,394163,124746,457424,0,0,2004161,1288460,21882,28794,9909.9,10.79,2026043,1317254
CT,2003,0,157252,0,41864,0,434313,167566,167566,167566,800995,31229,32973,9224.7,14.42,198795,833968
DC,2003,0,33700,0,173,0,29777,0,0,0,63650,925,926,1578.6,15.82,925,64576
DE,2003,0,47971,0,46997,0,136588,0,0,0,231556,1401,1401,2200.2,12.31,1401,232957
FL,2003,4543,714826,0,723832,18925,1931768,322868,322868,346336,3693294,188655,188488,34861.4,13.59,534991,3881782
GA,2003,0,390760,0,819031,0,1033435,346601,346601,346601,2589827,221665,221675,21438.8,10.79,568266,2811502
HI,2003,0,137,0,18044,0,269414,0,0,0,287595,13309,13318,3335.9,15.6,13309,300913
IA,2003,0,197629,0,444587,0,375212,41559,41559,41559,1058987,135112,93652,8506.8,10.45,176671,1152639
ID,2003,0,71754,0,10219,0,140328,0,0,0,222301,109553,108868,3186.9,10.7,109553,331169
IL,2003,244,1001534,721185,1010087,67843,1238292,987308,987308,1776580,4237221,159431,127073,30177,11.25,1936011,4364294
IN,2003,1591,566838,792236,1570700,10817,885902,0,0,804644,3023440,55292,57491,18953.8,9.17,859936,3080931
KS,2003,479745,284722,3307,389464,197043,419163,92648,92648,772743,1185997,26498,21917,7957.8,11.11,799241,1207914
KY,2003,92879,231384,2809836,943652,14720,644470,0,0,2917435,1819506,65615,70509,11270.3,9.77,2983050,1890015
LA,2003,1599277,1353179,54642,247978,522104,1954979,168069,168069,2344092,3724205,148609,152633,22948.7,8.58,2492701,3876838
MA,2003,0,414970,0,109373,0,730803,51880,51880,51880,1307026,50337,50418,16201.4,14.76,102217,1357444
MD,2003,50,204345,124609,329590,0,570714,142685,142685,267344,1247334,54135,54160,12458.1,12.34,321479,1301494
ME,2003,0,73517,0,7481,0,265720,0,0,0,346718,132344,132348,4098.3,11.22,132344,479066
MI,2003,248982,950714,0,747940,37514,968414,291332,291332,577828,2958400,103312,112635,24121.8,10.78,681140,3071035
MN,2003,0,374189,0,390691,0,671245,139799,139799,139799,1575924,113752,107570,13315.2,10.81,253551,1683494
MO,2003,0,265133,11380,795634,505,739036,101089,101089,112974,1900892,31603,34678,14446.7,11.36,144577,1935570
MS,2003,157366,275147,37626,178949,111946,480507,113625,113625,420563,1048228,45346,45369,8286.9,11.01,465909,1093597
MT,2003,88966,70048,665901,188981,112636,157136,0,0,867503,416165,100370,100455,2581.8,10.79,967873,516620
NC,2003,0,227387,0,771618,0,900018,426332,426332,426332,2325355,181552,188855,20310.3,12.29,607884,2514210
ND,2003,67756,56088,402709,420832,170584,121722,0,0,641049,598642,26158,24205,2104.2,7.39,667207,622847
NE,2003,1464,119741,0,227290,15967,229099,83344,83344,100775,659474,73956,45556,4745.3,10.8,174731,705030
NH,2003,0,56415,0,41633,0,200220,96677,96677,96677,394945,29849,29851,3457.3,14.15,126526,424796
NJ,2003,0,635689,0,106857,0,1146359,309629,309629,309629,2198534,26707,26805,21977,12.17,336336,2225339
NM,2003,1799677,225220,490629,305641,386216,248457,0,0,2676522,779318,9554,8743,4456.7,11.93,2686076,788061
NV,2003,6,191050,0,182553,2859,239284,0,0,2865,612887,33578,37158,5811.1,13.88,36443,650045
NY,2003,37113,1131344,0,286179,829,1760002,423959,423959,461901,3601484,357371,359374,43362.8,14.44,819272,3960858
OH,2003,97106,877891,539441,1443498,32816,1303901,88327,88327,757690,3713617,47969,63646,31148.7,11.49,805659,3777263
OK,2003,1723722,556306,37411,393790,376513,545461,0,0,2137646,1495557,41954,42001,10175.5,10.89,2179600,1537558
OR,2003,740,215102,0,44884,0,358058,0,0,740,618044,384479,386713,7962.9,11.97,385219,1004757
PA,2003,167346,717461,1599175,1461986,14303,1446911,774989,774989,2555813,4401347,109946,110613,32032.2,11.81,2665759,4511960
RI,2003,0,80339,0,101,0,102986,0,0,0,183426,3787,3827,2400.1,14.28,3787,187253
SC,2003,0,151904,0,419663,0,495840,525453,525453,525453,1592860,103796,103801,11025,11.1,629249,1696661
SD,2003,1104,43868,0,43017,7175,112417,0,0,8279,199302,67639,57222,2085.8,11.17,75918,256524
TN,2003,1862,265806,65617,621425,1804,755961,251718,251718,321001,1894910,190000,184237,15251.3,10.63,511001,2079147
TX,2003,5902223,4177143,594734,1603971,2323851,5978967,348485,348485,9169293,12108566,115456,117593,83176.3,9.76,9284749,12226159
UT,2003,289597,163527,536150,379185,75963,276298,0,0,901710,819010,10252,10520,4782.8,10.19,911962,829530
VA,2003,148815,272055,827937,464353,104,934350,258633,258633,1235489,1929391,104227,110936,17915.2,11.27,1339716,2040327
VT,2003,0,8441,0,25,0,87073,46317,46317,46317,141856,24054,24055,1681.6,14.66,70371,165911
WA,2003,0,255839,97712,118207,0,723154,79360,79360,177072,1176560,829196,834753,13364.5,11.5,1006268,2011313
WI,2003,0,397869,0,488239,0,579881,127310,127310,127310,1593299,115460,118300,14266.3,11.32,242770,1711599
WV,2003,212496,135367,3524504,978415,8590,211544,0,0,3745590,1325326,19809,21237,4669.7,9.68,3765399,1346563
WY,2003,1714636,120433,6551331,493897,307226,159203,0,0,8573193,773533,12064,11638,2483.4,8.8,8585257,785171
US,2003,21943403,22822564,22054837,22322634,11959565,38713457,7959622,7959622,63917427,91818277,5942366,5944059,755070.3,11.44,69859793,97762336
AK,2004,543764,407944,23587,14075,1928158,334121,0,0,2495509,756140,18416,18876,4148.2,11.07,2513925,775016
AL,2004,348224,391927,531179,853917,43169,609981,329898,329898,1252470,2185723,290697,293280,15099.3,11.27,1543167,2479003
AR,2004,189912,217921,157,270210,39133,361081,161111,161111,390313,1010323,112915,112971,8491.9,11.96,503228,1123294
AZ,2004,337,356264,278231,425413,313,558357,293158,293158,572039,1633192,81376,82473,13848.2,15.36,653415,1715665
CA,2004,356787,2462247,0,68909,1392800,3670782,315634,315634,2065221,6517572,697459,768889,89950.2,15.17,2762680,7286461
CO,2004,1149273,440720,889060,390186,130686,490984,0,0,2169019,1321890,22469,29099,11807.9,12.48,2191488,1350989
CT,2004,0,165862,0,43997,0,451366,172470,172470,172470,833695,30189,42965,10599.9,15.94,202659,876660
DC,2004,0,33097,0,741,0,30534,0,0,0,64372,942,943,1714.9,16.74,942,65315
DE,2004,0,49722,0,53599,0,127465,0,0,0,230786,1435,1436,2439.8,14.01,1435,232222
FL,2004,4374,757672,0,699055,16843,2095087,325516,325516,346733,3877330,179754,179495,41130.8,15.21,526487,4056825
GA,2004,0,406436,0,834991,0,1079645,351921,351921,351921,2672993,226890,226761,25535.2,12.42,578811,2899754
HI,2004,0,155,0,17913,0,282864,0,0,0,300932,13768,13786,4024.6,17.73,13768,314718
IA,2004,0,198017,0,443221,0,414787,51399,51399,51399,1107424,174335,111271,10009.4,11.9,225734,1218695
ID,2004,0,78273,0,12336,0,156496,0,0,0,247105,112379,112080,3740.4,11.68,112379,359185
IL,2004,242,955972,722774,1069538,63707,1285139,959869,959869,1746592,4270518,154365,126588,33593.6,12.47,1900957,4397106
IN,2004,3432,526391,786209,1614210,10179,865025,0,0,799820,3005626,54883,58085,20730.1,10.19,854703,3063711
KS,2004,456781,260117,1665,385498,196498,412120,105664,105664,760608,1163399,28341,19571,8795.6,12.56,788949,1182970
KY,2004,100915,233361,2845496,961759,14778,703989,0,0,2961189,1899109,69142,71188,13524,11.08,3030331,1970297
LA,2004,1609900,1393140,51659,256716,482978,2065896,178110,178110,2322647,3893862,185640,189772,28745.7,10.12,2508287,4083634
MA,2004,0,383625,0,105075,0,736401,61928,61928,61928,1287029,51070,51781,17815.8,16.33,112998,1338810
MD,2004,35,201801,129130,327239,0,590242,152043,152043,281208,1271325,53425,53460,14113.4,13.87,334633,1324785
ME,2004,0,89581,0,7336,0,260353,0,0,0,357270,136769,136776,4655.4,12.55,136769,494046
MI,2004,271801,938628,0,773825,34516,979694,318700,318700,625017,3010847,108765,118153,26772.5,12.14,733782,3129000
MN,2004,0,362346,0,378775,0,688025,138645,138645,138645,1567791,125527,114862,15167.2,12.14,264172,1682653
MO,2004,0,268289,12385,807466,510,744126,81658,81658,94553,1901539,40841,44121,16239.4,12.71,135394,1945660
MS,2004,87181,290512,36619,184992,111604,480422,106707,106707,342111,1062633,61251,61297,9494.9,12.56,403362,1123930
MT,2004,100261,68567,721570,195620,143364,176136,0,0,965195,440323,101507,101639,3173,12.37,1066702,541962
NC,2004,0,232214,0,782692,0,930984,418065,418065,418065,2363955,139795,147627,23221.1,13.92,557860,2511582
ND,2004,68399,56410,392966,398381,180682,133016,0,0,642047,587807,25922,24137,2537.8,8.77,667969,611944
NE,2004,1489,116006,0,223624,14535,233553,106796,106796,122820,679979,91627,52142,5404.9,12.21,214447,732121
NH,2004,0,63829,0,43446,0,205481,106132,106132,106132,418888,34923,34926,3948.8,15.58,141055,453814
NJ,2004,0,644467,0,112707,0,1164799,282407,282407,282407,2204380,27231,27603,26164.3,14.31,309638,2231983
NM,2004,1828178,229164,510869,309418,374199,255866,0,0,2713246,794448,12326,11714,5203.6,13.56,2725572,806162
NV,2004,5,221648,0,193634,2685,260161,0,0,2690,675443,34321,38001,7056,15.68,37011,713444
NY,2004,47247,1126597,0,276470,986,1823746,423797,423797,472030,3650610,358876,383432,48172.5,15.67,830906,4034042
OH,2004,94628,862397,568593,1391290,33541,1303260,166328,166328,863090,3723275,51267,66807,34592.2,12.84,914357,3790082
OK,2004,1838548,555273,41850,372093,371067,526834,0,0,2251465,1454200,62058,62153,11306.6,12.33,2313523,1516353
OR,2004,473,238049,0,36460,0,368456,0,0,473,642965,384622,387006,9090.6,13.21,385095,1029971
PA,2004,206085,723189,1600275,1474310,13897,1475233,807739,807739,2627996,4480471,110371,118023,35785.3,13.13,2738367,4598494
RI,2004,0,74352,0,76,0,98408,0,0,0,172836,3846,4535,2637.9,16.01,3846,177371
SC,2004,0,169518,0,433868,0,569746,533920,533920,533920,1707052,97431,97441,13170.8,12.4,631351,1804493
SD,2004,1095,41757,0,43562,7871,113059,0,0,8966,198378,83757,60251,2355.8,12.8,92723,258629
TN,2004,2169,238761,73354,648005,2094,765424,298369,298369,375986,1950559,185184,179906,17442,12.17,561170,2130465
TX,2004,5764490,4039787,572489,1626029,2277741,6161669,421660,421660,9036380,12249145,120812,123497,98235.3,11.41,9157192,12372642
UT,2004,297852,164154,490146,399704,85515,277475,0,0,873513,841333,10581,10715,5653.1,11.39,884094,852048
VA,2004,88073,285607,817769,452557,110,995785,295272,295272,1201224,2029221,110959,117963,21026.2,12.67,1312183,2147184
VT,2004,0,8708,0,25,0,95317,40231,40231,40231,144281,22039,22042,1988.3,15.96,62270,166323
WA,2004,0,269572,89958,112539,0,749526,93660,93660,183618,1225297,817635,819551,15460,13.06,1001253,2044848
WI,2004,0,385999,0,499212,0,606012,123966,123966,123966,1615189,108745,108704,16025.9,12.75,232711,1723893
WV,2004,222720,129358,3724793,937062,10063,230361,0,0,3957576,1296781,19228,20765,5385.5,10.85,3976804,1317546
WY,2004,1772333,111878,6908962,500526,301252,153076,0,0,8982547,765480,14434,14039,2859.7,10.31,8996981,779519
US,2004,21549505,22927283,22821746,22464302,11550085,40148362,8222774,8222774,64144110,93762721,6062543,6074599,871210.2,12.9,70206653,99837320
AK,2005,548394,434704,22682,13994,1829245,333091,0,0,2400321,781789,15866,15930,5215.8,13.99,2416187,797719
AL,2005,327318,363398,518423,890098,45594,606840,330761,330761,1222096,2191097,279600,279983,18088.3,13.56,1501696,2471080
AR,2005,193576,216600,67,247169,35815,358312,142864,142864,372322,964945,112661,112738,10416.1,14.46,484983,1077683
AZ,2005,239,329302,263426,428445,290,573763,269327,269327,533282,1600837,78333,92285,16665.8,17.87,611615,1693122
CA,2005,354384,2304463,0,67422,1335334,3741092,377313,377313,2067031,6490290,741338,819440,103574.2,17.46,2808369,7309730
CO,2005,1219801,478520,857038,386670,134717,489645,0,0,2211556,1354835,32983,35558,14654.8,15.15,2244539,1390393
CT,2005,0,171150,0,42023,0,443947,162406,162406,162406,819526,25727,29171,12423.7,19.62,188133,848697
DC,2005,0,33753,0,939,0,28656,0,0,0,63348,47,263,2013,20.08,47,63611
DE,2005,0,48639,0,56716,0,135389,0,0,0,240744,954,1886,2937.2,16.48,954,242630
FL,2005,3637,805446,0,672309,14993,2130793,300127,300127,318757,3908675,184304,187675,49999,17.97,503061,4096350
GA,2005,0,427825,0,901010,0,1120350,329092,329092,329092,2778277,216430,218423,32370.7,15.29,545522,2996700
HI,2005,0,195,0,16506,0,293847,0,0,0,310548,12935,14186,4996.9,21.39,12935,324734
IA,2005,0,210742,0,429777,0,428465,47362,47362,47362,1116346,215149,124866,12256.1,14.3,262511,1241212
ID,2005,0,78118,0,11286,0,159726,0,0,0,249130,121084,122267,4531.4,13.65,121084,371397
IL,2005,234,972710,727433,1047532,59201,1403414,973293,973293,1760161,4396949,138337,109784,41443.4,14.75,1898498,4506733
IN,2005,3191,535512,768995,1594399,10017,859731,0,0,782203,2989642,58589,63826,25074.3,12.6,840792,3053468
KS,2005,432051,258695,3955,379823,194996,341906,92055,92055,723057,1072479,31101,22986,9303.3,14.9,754158,1095465
KY,2005,97907,240853,2973897,986263,14703,697645,0,0,3086507,1924761,67438,74724,16633.5,13.57,3153945,1999485
LA,2005,1514680,1367497,61534,253518,436154,1975571,163598,163598,2175966,3760184,151309,151854,35459.1,13.13,2327275,3912038
MA,2005,0,386339,0,119333,0,737337,57138,57138,57138,1300147,40795,46953,21568.6,19.51,97933,1347100
MD,2005,48,211830,126671,329304,0,603981,153443,153443,280162,1298558,43642,48562,17428.9,16.83,323804,1347120
ME,2005,0,64818,0,7059,0,263938,0,0,0,335815,159674,160078,5619.3,14.89,159674,495893
MI,2005,270311,927535,0,799463,33257,978894,343048,343048,646616,3048940,116821,130906,32127.3,14.53,763437,3179846
MN,2005,0,372082,0,379114,0,700917,133948,133948,133948,1586061,142459,123801,18259.1,14.45,276407,1709862
MO,2005,0,273386,12954,835663,499,741961,83807,83807,97260,1934817,52554,54637,19679,15.12,149814,1989454
MS,2005,77573,310713,36231,176286,102631,455899,105172,105172,321607,1048070,62678,62951,11395.5,15.37,384285,1111021
MT,2005,114001,71089,726845,199495,190165,182921,0,0,1031011,453505,113989,114898,4036.5,14.89,1145000,568403
NC,2005,0,237525,0,811939,0,947056,417249,417249,417249,2413769,145275,147480,27966.3,16.51,562524,2561249
ND,2005,67863,49643,392566,431133,206915,136531,0,0,667344,617307,23400,22847,3123.2,10.5,690744,640154
NE,2005,1183,120125,0,228667,13966,228762,91856,91856,107005,669410,94833,51713,6448,14.69,201838,721123
NH,2005,0,72934,0,44169,0,190420,98682,98682,98682,406205,41288,42485,4602.9,18.46,139970,448690
NJ,2005,0,625429,0,125332,0,1225835,327604,327604,327604,2304200,19937,29321,30945.9,16.31,347541,2333521
NM,2005,1828036,225352,536980,317916,353585,254624,0,0,2718601,797892,24068,23591,6403.3,16.54,2742669,821483
NV,2005,5,236007,0,197799,2593,275627,0,0,2598,709433,34479,38191,8493,18.01,37077,747624
NY,2005,56560,1107206,0,256879,1172,1807239,442937,442937,500669,3614261,365538,374254,56292,19.01,866207,3988515
OH,2005,87155,860874,606427,1481045,32816,1280172,154481,154481,880879,3776572,54495,73750,41386.2,15.39,935374,3850322
OK,2005,1824461,600011,39664,397379,355320,557797,0,0,2219445,1555187,61329,65251,14247.8,14.83,2280774,1620438
OR,2005,468,239539,0,35624,0,374572,0,0,468,649735,364066,368234,10720.1,15.26,364534,1017969
PA,2005,176552,719117,1607811,1490836,14268,1498536,796157,796157,2594788,4504646,104224,109625,42406.8,15.66,2699012,4614271
RI,2005,0,82460,0,76,0,97180,0,0,0,179716,879,1923,3098.9,19.02,879,181639
SC,2005,0,178308,0,431086,0,547413,554544,554544,554544,1711351,104205,105466,15556.8,14.93,658749,1816817
SD,2005,999,42848,0,36952,8085,118214,0,0,9084,198014,93723,61504,2910.6,15.18,102807,259518
TN,2005,2277,238400,82083,657711,1879,782703,290153,290153,376392,1968967,167074,174097,21504,14.65,543466,2143064
TX,2005,5973867,3621139,595612,1627863,2277086,5987815,398994,398994,9245559,11635811,138300,140202,118064.4,14.72,9383859,11776013
UT,2005,321479,168770,554221,405546,96703,287599,0,0,972403,861915,13607,15773,6980.2,13.73,986010,877688
VA,2005,92154,311537,716557,458452,151,998762,291357,291357,1100219,2060108,127185,132464,25908.1,14.98,1227404,2192572
VT,2005,0,8396,0,25,0,90539,42491,42491,42491,141451,24325,24499,2296.9,18.66,66816,165950
WA,2005,0,272167,82685,112284,0,768653,86016,86016,168701,1239120,807731,815363,18344,14.99,976432,2054483
WI,2005,0,415583,0,522521,0,596603,103535,103535,103535,1638242,144880,145127,19225.8,15.08,248415,1783369
WV,2005,250088,124984,3848482,959657,9837,231304,0,0,4108407,1315945,28331,28742,6390.2,13.24,4136738,1344687
WY,2005,1811903,112863,7019843,490940,300266,155289,0,0,9132012,759092,19105,19291,3610.7,12.94,9151117,778383
US,2005,20900370,22567132,23183084,22793450,10974163,40227276,8160810,8160810,63218427,93748668,6219077,6231821,1045730.4,15.57,69437504,99980489
AK,2006,497073,375719,22230,14981,1568790,342272,0,0,2088093,732972,13298,13481,6118.4,16.61,2101391,746453
AL,2006,326288,402044,443032,886678,43726,611265,332992,332992,1146038,2232979,266153,266931,20165.3,14.96,1412191,2499910
AR,2006,278724,240885,516,256907,34498,358679,158952,158952,472690,1015423,100949,100633,11450.5,15.78,573639,1116056
AZ,2006,623,365230,179356,431985,319,582623,250568,250568,430866,1630406,80771,95745,18868.5,19.7,511637,1726151
CA,2006,351706,2375929,0,67017,1293487,3786528,333488,333488,1978681,6562962,822155,897576,115739.4,19.4,2800836,7460538
CO,2006,1295490,458911,805711,394348,142106,506709,0,0,2243307,1359968,45458,42229,16309.6,16.94,2288765,1402197
CT,2006,0,175870,0,45722,0,391609,173111,173111,173111,786312,25700,35689,13711.2,23.09,198811,822001
DC,2006,0,29775,0,0,0,22535,0,0,0,52310,51,619,2161.3,24.03,51,52929
DE,2006,0,44787,0,56625,0,122657,0,0,0,224069,870,3619,3421.5,19.76,870,227688
FL,2006,3501,917468,0,696215,13688,2018975,327934,327934,345123,3960592,186848,192085,58757.6,20.75,531971,4152677
GA,2006,0,433920,0,892732,0,1089023,333981,333981,333981,2749656,207730,210818,34265.7,16.45,541711,2960474
HI,2006,0,179,0,16102,0,295474,0,0,0,311755,13998,15528,5729.1,24.33,13998,327283
IA,2006,0,207162,0,435187,0,435701,53171,53171,53171,1131221,271182,142841,13544.5,15.59,324353,1274062
ID,2006,0,79041,0,8212,0,165353,0,0,0,252606,146507,147673,5076.3,15.07,146507,400279
IL,2006,236,896138,740927,1045398,59879,1340467,982498,982498,1783540,4264501,136525,109454,42631,15.91,1920065,4373955
IN,2006,2971,499753,783367,1587100,10283,860450,0,0,796621,2947303,48968,55594,27080.2,13.91,845589,3002897
KS,2006,424422,269274,9591,364212,206874,351672,97570,97570,738457,1082728,39697,28423,10508.3,16.19,778154,1111151
KY,2006,101101,217166,3000879,1023263,13572,699444,0,0,3115552,1939873,62393,70058,18136.5,15,3177945,2009931
LA,2006,1571921,1346690,57533,265214,426990,2127341,174634,174634,2231078,3913879,149821,150707,40601,14.25,2380899,4064586
MA,2006,0,378026,0,112173,0,648398,60832,60832,60832,1199429,45553,62215,24313.7,23.41,106385,1261644
MD,2006,50,189179,122170,324657,0,538678,144320,144320,266540,1196834,45594,59415,19403.3,20.02,312134,1256249
ME,2006,0,67557,0,6618,0,235253,0,0,0,309428,152339,152966,6214.9,17.13,152339,462394
MI,2006,271909,816993,0,773595,33924,926618,303305,303305,609138,2820511,117111,130017,34457,16.66,726249,2950528
MN,2006,0,358198,0,370814,0,680945,137569,137569,137569,1547526,164929,129807,19840.6,16.08,302498,1677333
MO,2006,0,257924,8549,829054,505,736536,105567,105567,114621,1929081,45213,43545,21411.9,16.67,159834,1972626
MS,2006,84536,315909,38844,190057,100665,469598,108718,108718,332763,1084282,63223,63632,13028.1,16.98,395986,1147914
MT,2006,116906,75135,754967,194307,210505,194283,0,0,1082378,463725,122239,123334,4684,16.38,1204617,587059
NC,2006,0,230169,0,777871,0,918121,417016,417016,417016,2343177,136769,139856,30080.3,18.16,553785,2483033
ND,2006,71364,50007,397481,414838,229628,136542,0,0,698473,601387,26086,25802,3404.8,11.36,724559,627189
NE,2006,1214,131424,0,227444,13415,228780,93943,93943,108572,681591,103072,55259,7216.7,15.94,211644,736850
NH,2006,0,64644,0,44807,0,167795,98067,98067,98067,375313,33103,36022,4994.9,21.84,131170,411335
NJ,2006,0,566724,0,116093,0,1175190,339846,339846,339846,2197853,22080,47800,34337.7,19.02,361926,2245653
NM,2006,1780567,227661,485090,316221,344822,268257,0,0,2610479,812139,29384,28385,7181.5,18.35,2639863,840524
NV,2006,5,257595,0,84225,2471,291217,0,0,2476,633037,38352,41987,9958.6,20.05,40828,675024
NY,2006,57156,1120196,0,256345,1810,1556773,440606,440606,499572,3373920,378622,401535,58973.5,21.14,878194,3775455
OH,2006,89688,770872,557935,1450797,31546,1289366,175798,175798,854967,3686833,55793,77290,44539.7,17.14,910760,3764123
OK,2006,1880459,644381,43052,384418,372569,583533,0,0,2296080,1612332,50325,54844,16329.9,16.46,2346405,1667176
OR,2006,641,229731,0,26895,0,381213,0,0,641,637839,433010,438058,12219.4,16.91,433651,1075897
PA,2006,184081,684695,1583197,1499292,15016,1430279,785731,785731,2568025,4399997,107632,119645,46149.4,17.57,2675657,4519642
RI,2006,0,78517,0,49,0,90465,0,0,0,169031,2629,5429,3476.4,22.56,2629,174460
SC,2006,0,181895,0,432220,0,551756,530071,530071,530071,1695942,100251,100539,16951,16.12,630322,1796481
SD,2006,966,40861,0,39570,8062,116224,0,0,9028,196655,114833,71514,3188,16.84,123861,268169
TN,2006,2764,230047,71957,677174,1114,785896,257523,257523,333358,1950640,143513,151732,23803.8,16.38,476871,2102372
TX,2006,6249274,3544789,593496,1610301,2276390,6086196,430593,430593,9549753,11671879,154257,193518,136021.7,16.78,9704010,11865397
UT,2006,372099,197894,593321,382757,103977,310505,0,0,1069397,891156,13202,15066,8294.6,15.88,1082599,906222
VA,2006,106530,283456,768443,433606,99,958756,287938,287938,1163010,1963756,119684,133344,27851.1,16.63,1282694,2097100
VT,2006,0,8062,0,27,0,88725,53287,53287,53287,150101,27595,27854,2533.6,21.03,80882,177955
WA,2006,0,271034,40268,69150,0,795563,97341,97341,137609,1233088,928254,937172,21188.4,16.46,1065863,2170260
WI,2006,0,376559,0,462732,0,589851,127657,127657,127657,1556799,144625,140855,20666.4,16.75,272282,1697654
WV,2006,265874,126316,3802035,958880,10011,236344,0,0,4077920,1321540,28268,28884,7044.4,14.39,4106188,1350424
WY,2006,1990659,112929,7739988,489325,307249,166896,0,0,10037896,769150,19351,19573,4276.9,14.55,10057247,788723
US,2006,21381434,22225318,23643934,22444214,10766766,39743329,8214626,8214626,64006760,92627487,6585966,6636591,1158820.6,17.4,70592726,99264078
AK,2007,489308,372186,20654,13662,1528851,323089,0,0,2038813,708937,14037,14286,6272,17.94,2052850,723223
AL,2007,307971,430649,469036,888436,41592,601179,360036,360036,1178635,2280300,228703,229491,21315.1,16.06,1407338,2509791
AR,2007,273910,229610,1863,275037,34980,359757,162434,162434,473187,1026838,121735,121766,12200.2,16.68,594922,1148604
AZ,2007,670,401992,173934,438524,249,571417,280920,280920,455773,1692853,83248,97679,20137.4,20.87,539021,1790532
CA,2007,343379,2467545,0,66495,1267404,3795097,375427,375427,1986210,6704564,632075,707404,121101,20.15,2618285,7411968
CO,2007,1336499,512841,815511,388586,151861,513431,0,0,2303871,1414858,54145,50616,17030.5,17.06,2358016,1465474
CT,2007,0,183604,0,39931,0,377002,171874,171874,171874,772411,24028,36171,15146.3,25.31,195902,808582
DC,2007,0,33856,0,502,0,21547,0,0,0,55905,54,741,2371.5,24.57,54,56646
DE,2007,0,49932,0,63839,0,119810,0,0,0,233581,1529,4972,3646.3,21.06,1529,238553
FL,2007,2071,943845,0,720824,12052,1938437,307215,307215,321338,3910321,191796,199921,60500,21.67,513134,4110242
GA,2007,0,455220,0,934773,0,1052558,341364,341364,341364,2783915,201333,205849,35464.7,17.33,542697,2989764
HI,2007,0,173,0,17107,0,303540,0,0,0,320820,15029,16995,6177.1,24.98,15029,337815
IA,2007,0,264166,0,465167,0,420924,47398,47398,47398,1197655,342569,176851,14669.3,16.09,389967,1374506
ID,2007,0,83904,0,10261,0,162468,0,0,0,256633,125621,127411,5437.1,15.91,125621,384044
IL,2007,1479,968652,748745,1091382,55732,1324077,1004100,1004100,1810056,4388211,168587,130912,47370.7,17.3,1978643,4519123
IN,2007,3685,543800,783017,1572084,10017,834645,0,0,796719,2950529,72434,67602,28301.6,14.46,869153,3018131
KS,2007,414251,291695,9313,396333,212222,402282,108762,108762,744548,1199072,49690,36181,12577.4,17.32,794238,1235253
KY,2007,100611,235876,2872880,1020709,15463,690076,0,0,2988954,1946661,56251,65820,19714.5,16,3045205,2012481
LA,2007,1577182,1430621,42871,249800,446472,2130984,179127,179127,2245652,3990532,150497,151977,43812.3,15.14,2396149,4142509
MA,2007,0,418907,0,120168,0,647827,53701,53701,53701,1240603,38235,59616,25774.9,24.18,91936,1300219
MD,2007,36,208439,53756,327979,0,531469,150551,150551,204343,1218438,40873,58135,21300.8,21.62,245216,1276573
ME,2007,0,67227,0,6583,0,233431,0,0,0,307241,155620,156513,6964.6,18.83,155620,463754
MI,2007,274595,814887,0,801178,33211,919768,330581,330581,638387,2866414,133054,140683,36088.5,17.57,771441,3007097
MN,2007,0,395658,0,366208,0,678958,137437,137437,137437,1578261,185052,153230,21749.6,17.12,322489,1731491
MO,2007,0,277919,5290,802879,464,730638,98302,98302,104056,1909738,65428,62175,23240.1,17.8,169484,1971913
MS,2007,95280,374990,36159,185063,119898,460954,98164,98164,349501,1119171,66060,64570,13387.8,17.35,415561,1183741
MT,2007,121193,75077,778069,202480,202461,206442,0,0,1101723,483999,117749,119592,5271.7,17.28,1219472,603591
NC,2007,0,244475,0,827974,0,920732,420029,420029,420029,2413210,113126,117419,32202,19.41,533155,2530629
ND,2007,76920,56842,385056,420719,259770,139972,0,0,721746,617533,43992,32353,3958.3,12.75,765738,649886
NE,2007,1583,153490,0,216872,13543,229195,115815,115815,130941,715372,129955,64219,7956.6,16.73,260896,779591
NH,2007,0,64856,0,44899,0,165020,112902,112902,112902,387677,34804,38434,5338.4,23.25,147706,426111
NJ,2007,0,640236,0,111799,0,1241757,335757,335757,335757,2329549,20736,52951,38007.3,19.67,356493,2382500
NM,2007,1690846,239858,455522,296067,343238,277635,0,0,2489606,813560,32764,32003,7855.5,19.16,2522370,845563
NV,2007,5,262547,0,82871,2366,285879,0,0,2371,631297,37718,42138,10538.9,21.28,40089,673435
NY,2007,56206,1214349,0,258450,2198,1562784,445288,445288,503692,3480871,363732,392381,63250.7,21.98,867424,3873252
OH,2007,91366,835555,555706,1463773,29899,1284301,165349,165349,842320,3748978,62087,84298,47612.3,17.77,904407,3833276
OK,2007,1978256,677472,34845,373217,364826,563473,0,0,2377927,1614162,74304,82596,17059.8,17.07,2452231,1696758
OR,2007,422,260240,0,45461,0,374647,0,0,422,680348,396903,402132,13149.4,18.21,397325,1082480
PA,2007,190587,780090,1557006,1491907,16170,1402752,811600,811600,2575363,4486349,106474,121913,48798.9,18.34,2681837,4608262
RI,2007,0,90259,0,39,0,87046,0,0,0,177344,2779,6398,3558,22.96,2779,183742
SC,2007,0,182201,0,444046,0,533797,558014,558014,558014,1718058,98956,97885,17708.3,17.2,656970,1815943
SD,2007,998,54099,0,33256,9651,117482,0,0,10649,204837,115685,69575,3616.8,17.69,126334,274412
TN,2007,4092,229520,67714,672766,1647,773597,301038,301038,374491,1976921,116436,126960,25111.3,17.32,490927,2103881
TX,2007,6850716,3626526,554720,1609155,2269314,5917140,429577,429577,10104327,11582398,197390,250482,142017.3,17.79,10301717,11832880
UT,2007,399971,231125,556436,391386,113303,299418,0,0,1069710,921929,11031,14230,8693.9,16.51,1080741,936159
VA,2007,115979,331018,656314,458200,110,958752,286019,286019,1058422,2033989,117796,135794,29867.3,17.56,1176218,2169783
VT,2007,0,8874,0,34,0,86757,49337,49337,49337,145002,18652,19025,2723.7,22.9,67989,164027
WA,2007,0,279429,0,95737,0,820408,85051,85051,85051,1280625,884848,894490,23030.5,17.71,969899,2175115
WI,2007,0,403947,0,465083,0,584630,135416,135416,135416,1589076,150029,142051,22363.5,17.95,285445,1731127
WV,2007,262708,124555,3855269,983259,11554,235366,0,0,4129531,1343180,26024,26873,7590.2,15.02,4155555,1370053
WY,2007,2231308,145985,7847634,494955,313873,169430,0,0,10392815,810370,18322,18963,4489.6,14.95,10411137,829333
US,2007,22182362,23670821,23337321,22747914,10741443,39383775,8458589,8458589,64719715,94261099,6509976,6522719,1233868.7,18.34,71229691,100783818
AK,2008,448503,343938,23041,14705,1449379,278725,0,0,1920923,637368,12913,13126,7549.4,23.91,1933836,650494
AL,2008,289280,414260,506837,842826,44637,566323,407551,407551,1248305,2230960,234001,237856,24410.3,19.22,1482306,2468816
AR,2008,453357,238424,1548,278849,35258,354937,148085,148085,638248,1020295,124882,126307,14387.8,19.96,763130,1146602
AZ,2008,537,409966,173998,458727,313,542166,305726,305726,480574,1716585,96744,111984,22394.7,23.95,577318,1828569
CA,2008,331830,2472612,0,63050,1244291,3553537,339506,339506,1915627,6428705,604057,680290,134480.1,23.25,2519684,7108995
CO,2008,1493824,508491,714673,385416,173687,486432,0,0,2382184,1380339,80049,77341,19560.4,19.81,2462233,1457680
CT,2008,0,169802,0,45188,0,339919,161305,161305,161305,716214,26348,36453,16223.9,29.1,187653,752667
DC,2008,0,32774,0,391,0,18444,0,0,0,51609,63,563,2493,27.52,63,52172
DE,2008,0,49749,0,60891,0,112725,0,0,0,223365,2950,5787,4129.6,24.35,2950,229152
FL,2008,2545,970038,0,693161,11327,1717483,335857,335857,349729,3716539,195231,242563,67432.2,25.21,544960,3959102
GA,2008,0,436093,0,885849,0,946224,331235,331235,331235,2599401,174517,198357,40523.7,21.01,505752,2797758
HI,2008,0,148,0,18095,0,239055,0,0,0,257298,15907,19327,6828.5,35.87,15907,276625
IA,2008,0,297357,0,485218,0,423828,55210,55210,55210,1261613,413336,213180,17242.1,18.05,468546,1474793
ID,2008,0,90550,0,8604,0,152495,0,0,0,251649,133541,132857,6097.9,18.09,133541,384506
IL,2008,1266,1003219,758122,1103163,54694,1274262,994526,994526,1808608,4375170,199716,160653,54789.7,19.87,2008324,4535823
IN,2008,4762,555489,803043,1558078,10782,778521,0,0,818587,2892088,131764,99311,32469.4,17.08,950351,2991399
KS,2008,427313,292523,5139,371804,230045,349719,88812,88812,751309,1102858,85267,58223,13469.9,19.85,836576,1161081
KY,2008,121259,233165,2927900,1024816,15341,645708,0,0,3064500,1903689,61024,71481,22712.4,19.07,3125524,1975170
LA,2008,1562562,1369823,54763,262470,419607,2193330,160658,160658,2197590,3986281,109774,114723,57869.7,19.87,2307364,4101004
MA,2008,0,415247,0,106897,0,621929,61339,61339,61339,1205412,42731,60558,29228.1,27.38,104070,1265970
MD,2008,29,202744,65597,309294,0,507179,153422,153422,219048,1172639,44833,60163,24170.5,25.32,263881,1232802
ME,2008,0,74494,0,5908,0,201971,0,0,0,282373,182576,186763,7599,20.35,182576,469136
MI,2008,161842,797534,0,799969,36946,836361,329075,329075,527863,2762939,146310,158418,39005,19.53,674173,2921357
MN,2008,0,435086,0,359359,0,643535,135843,135843,135843,1573823,218973,179586,24656.6,19.06,354816,1753409
MO,2008,0,298421,5413,792918,574,675205,98025,98025,104012,1864569,89945,84232,25757.2,20.36,193957,1948801
MS,2008,114855,364237,28807,177166,128203,422379,98215,98215,370080,1061997,50044,50436,15499.9,21.34,420124,1112433
MT,2008,116656,77645,794235,203260,183257,192417,0,0,1094148,473322,123136,125437,6049.7,20.47,1217284,598759
NC,2008,0,249654,0,794693,0,883566,415742,415742,415742,2343655,143052,167201,37076.4,22.11,558794,2510856
ND,2008,68855,60480,387403,424615,361468,137092,0,0,817726,622187,58719,43508,4677.4,14.99,876445,665695
NE,2008,3116,172858,0,234654,13885,219571,99075,99075,116076,726158,177032,84810,9103,18.65,293108,810968
NH,2008,0,74025,0,40241,0,160994,97729,97729,97729,372989,39884,43631,6041.2,26.66,137613,416620
NJ,2008,0,634694,0,97671,0,1216492,336500,336500,336500,2285357,23381,50637,44711.1,23.61,359881,2335994
NM,2008,1608955,252831,475817,284346,348899,241949,0,0,2433671,779126,35367,36694,8485.7,22.56,2469038,815820
NV,2008,4,274915,0,88619,2529,259144,0,0,2533,622678,37866,44483,11117.3,23.67,40399,667161
NY,2008,51377,1205137,0,228985,2245,1480358,451622,451622,505244,3366102,399476,428750,71673.5,25.29,904720,3794852
OH,2008,88252,823457,638424,1438432,29510,1232449,183055,183055,939241,3677393,110716,116287,53732.5,20.36,1049957,3793680
OK,2008,2099841,711379,29851,391688,390334,540101,0,0,2520026,1643168,75383,87945,20580.9,20.39,2595409,1731113
OR,2008,796,274659,0,41408,0,356012,0,0,796,672079,414454,418899,14780.8,20.88,415250,1090978
PA,2008,207599,778251,1591997,1421091,17394,1380331,822134,822134,2639124,4401807,117868,147224,56585.9,21.41,2756992,4549031
RI,2008,0,91220,0,0,0,89555,0,0,0,180775,2965,6306,4124.9,26.42,2965,187081
SC,2008,0,175858,0,445454,0,502602,541026,541026,541026,1664940,96543,106872,20631.3,20.56,637569,1771812
SD,2008,1649,65453,0,43098,9860,112732,0,0,11509,221283,144447,82021,4223.3,19.66,155956,303304
TN,2008,4874,238441,59086,643796,1960,714765,282514,282514,348434,1879516,135439,150056,29078,20.63,483873,2029572
TX,2008,7711507,3653462,515493,1605925,2354440,5245208,425682,425682,11007122,10930277,306973,351072,161247.2,21.71,11314095,11281349
UT,2008,463709,237414,564147,395878,127826,279173,0,0,1155682,912465,13953,17793,9741.4,18.7,1169635,930258
VA,2008,133335,310647,623303,415102,93,870324,291932,291932,1048663,1888005,117907,140866,34088.7,21.18,1166570,2028871
VT,2008,0,8665,0,0,0,77454,51163,51163,51163,137282,27029,28824,2990.1,27.01,78192,166106
WA,2008,0,307085,0,94601,0,766791,96886,96886,96886,1265363,882230,898118,26365,20.61,979116,2163481
WI,2008,0,415109,0,480712,0,558483,127039,127039,127039,1581343,178495,160022,25079.5,20.14,305534,1741365
WV,2008,277186,119617,3870325,955628,12331,221682,0,0,4159842,1296927,29407,33587,8672.2,17.64,4189249,1330514
WY,2008,2463041,147129,8087435,500109,307661,169975,0,0,10858137,817213,21703,22477,5456.1,17.86,10879840,839690
US,2008,23102917,23836273,23706398,22382816,10613292,36791612,8426491,8426491,65849098,91437192,7190918,7174060,1408759.3,21.53,73040016,98611252
AK,2009,443666,343971,29016,14505,1365958,264885,0,0,1838640,623361,15685,15912,5487.2,18.22,1854325,639273
AL,2009,267121,466272,459529,630969,41696,517082,415392,415392,1183738,2029715,264530,274392,18497.3,16.55,1448268,2304107
AR,2009,691076,248100,112,264083,33379,335123,158663,158663,883230,1005969,125695,130887,10567.4,15.64,1008925,1136856
AZ,2009,727,377504,160706,413260,267,497660,320692,320692,482392,1609116,80882,96257,17469.9,20.14,563274,1705373
CA,2009,310439,2391374,0,52403,1202120,3405446,332218,332218,1844777,6181441,646698,725594,104556.9,18.68,2491475,6907035
CO,2009,1620932,525999,614581,350224,176285,465666,0,0,2411798,1341889,80083,78297,14673.9,15.52,2491881,1420186
CT,2009,0,188570,0,26265,0,338792,174220,174220,174220,727847,29512,41664,13357.5,23.65,203732,769511
DC,2009,0,34339,0,331,0,22477,0,0,0,57147,48,619,2342.6,24.38,48,57766
DE,2009,0,51651,0,33938,0,85876,0,0,0,171465,3574,6637,3563.7,21.23,3574,178102
FL,2009,263,1081725,0,581517,4037,1576612,304544,304544,308844,3544398,213639,272931,54481.6,21.32,522483,3817329
GA,2009,0,475240,0,723449,0,991848,331368,331368,331368,2521905,195373,220565,32128.5,16.7,526741,2742470
HI,2009,0,167,0,17083,0,238955,0,0,0,256205,15792,19688,4804.8,25.21,15792,275893
IA,2009,0,283990,0,444574,0,416419,48937,48937,48937,1193920,547827,289408,13397.1,14.31,596764,1483328
ID,2009,0,87072,0,8443,0,144545,0,0,0,240060,134502,136273,4922.9,15.56,134502,376333
IL,2009,1503,956553,783300,1014972,52774,1196579,998562,998562,1836139,4166666,251020,186174,40662.2,15.78,2087159,4352840
IN,2009,5001,511289,800172,1365413,10457,747721,0,0,815630,2624423,157512,118682,24606.7,14.04,973142,2743105
KS,2009,399685,292425,4296,356079,228903,346515,91710,91710,724594,1086729,91075,66668,10310,15.67,815669,1153397
KY,2009,121695,214261,2616139,937106,15132,640072,0,0,2752966,1791439,72836,85039,17505.7,15.28,2825802,1876478
LA,2009,1731327,1315265,50481,252519,400009,2043025,175524,175524,2357341,3786333,107145,119238,34713.8,12.79,2464486,3905571
MA,2009,0,408509,0,92056,0,571126,56437,56437,56437,1128128,49324,69061,22716.6,22.08,105761,1197189
MD,2009,45,203604,53448,266860,0,508121,152180,152180,205673,1130765,48410,66644,20138.6,21.11,254083,1197409
ME,2009,0,73569,0,1652,0,202702,0,0,0,277923,148204,153514,5760.9,17.48,148204,431437
MI,2009,160080,750783,0,735907,36296,803633,228540,228540,424916,2518863,131656,149749,31281.9,16.8,556572,2668612
MN,2009,0,405516,0,328678,0,593753,129623,129623,129623,1457570,262846,203854,18439.1,15.38,392469,1661424
MO,2009,0,266711,9626,765617,615,644431,107175,107175,117416,1783934,101279,92068,20033.9,16.69,218695,1876002
MS,2009,116540,371245,35109,141675,135302,399195,115033,115033,401984,1027148,55625,56832,11558.1,16.83,457609,1083980
MT,2009,101900,76635,703719,172812,161443,182297,0,0,967062,431744,113798,116455,4486.6,16.14,1080860,548199
NC,2009,0,252729,0,678673,0,798784,427226,427226,427226,2157412,148859,179898,28801.6,18.53,576085,2337310
ND,2009,80485,51921,391800,423267,462794,127743,0,0,935079,602931,85152,64260,3410.7,11.34,1020231,667191
NE,2009,2943,165418,0,249593,12986,216104,98682,98682,114611,729797,178841,86963,7189.6,14.88,293452,816760
NH,2009,0,62049,0,32844,0,154095,92214,92214,92214,341202,45367,49904,4905.1,22.09,137581,391106
NJ,2009,0,638324,0,59563,0,1030179,359036,359036,359036,2087102,33744,66283,33094,19.11,392780,2153385
NM,2009,1549619,247947,466100,306162,354832,226557,0,0,2370551,780666,31000,33261,6328.2,17.86,2401551,813927
NV,2009,4,284007,0,83812,2540,237095,0,0,2544,604914,46713,54225,8896.2,20.01,49257,659139
NY,2009,45791,1166614,0,155965,1931,1385849,454806,454806,502528,3163234,369963,409737,56046.9,20.73,872491,3572971
OH,2009,92466,770759,670150,1267267,28362,1124661,159040,159040,950018,3321727,97090,114671,40806.2,16.99,1047108,3436398
OK,2009,2124055,681062,18277,373271,389609,504395,0,0,2531941,1558728,81605,92578,14994.5,15.92,2613546,1651306
OR,2009,841,254837,0,33150,0,348602,0,0,841,636589,415649,423040,12037,17.58,416490,1059629
PA,2009,286260,839453,1439895,1223937,17209,1246075,808770,808770,2552134,4118235,128934,165867,43376.3,18.13,2681068,4284102
RI,2009,0,94877,0,0,0,91589,0,0,0,186466,3565,7418,3436.5,21.52,3565,193884
SC,2009,0,197419,0,371981,0,512746,545434,545434,545434,1627580,103035,121866,16347.2,16.76,648469,1749446
SD,2009,2133,66317,0,37480,9651,115110,0,0,11784,218907,179384,106123,3406.6,15.42,191168,325030
TN,2009,5631,223019,50347,477713,1554,655512,281996,281996,339528,1638240,179234,192435,22021.9,17.14,518762,1830675
TX,2009,7572107,3481133,455507,1497854,2316097,5058739,434024,434024,10777735,10471750,304800,352946,111233,15.75,11082535,10824696
UT,2009,475218,223646,502598,364994,133064,264282,0,0,1110880,852922,15950,20364,7424.9,15.03,1126830,873286
VA,2009,145805,330369,535643,334605,70,810586,295072,295072,976590,1770632,115242,144884,26661.1,17.56,1091832,1915516
VT,2009,0,8679,0,0,0,84448,56067,56067,56067,149194,31572,34193,2552.1,21.15,87639,183387
WA,2009,0,319739,0,84048,0,732582,69385,69385,69385,1205754,832840,853813,20982.3,16.78,902225,2059567
WI,2009,0,392485,0,425941,0,518538,132653,132653,132653,1469617,171835,153699,19382.5,16.7,304488,1623316
WV,2009,301044,118643,3379357,742922,8706,191464,0,0,3689107,1053029,45121,50902,6834.9,15.98,3734228,1103931
WY,2009,2536150,147220,7459876,473912,298880,163336,0,0,10294906,784468,34009,35036,3935.8,13.64,10328915,819504
US,2009,23689477,23421003,21689785,19691342,11340125,34779630,8355220,8355220,65074607,86247195,7624076,7607468,1066528.4,17.26,72698683,93854663
AK,2010,419310,334978,33556,14548,1269643,272455,0,0,1722509,621981,16965,17148,6320.1,20.56,1739474,639129
AL,2010,256117,544405,493094,718684,41499,521156,396557,396557,1187267,2180802,242242,266139,21629.4,17.8,1429509,2446941
AR,2010,938086,274774,718,293689,33251,342608,157017,157017,1129072,1068088,126234,138624,12309,16.87,1255306,1206712
AZ,2010,186,336208,167930,457909,215,549707,326102,326102,494433,1669926,84742,100835,20320.2,22,579175,1770761
CA,2010,320668,2325411,0,54972,1162146,3248203,336562,336562,1819376,5965148,713821,836280,116275.5,21.23,2533197,6801428
CO,2010,1730439,505628,551825,382623,191794,483122,0,0,2474058,1371373,83518,82338,17068.6,17.54,2557576,1453711
CT,2010,0,203814,0,28711,0,331959,175074,175074,175074,739558,30339,43526,14328.9,25.6,205413,783084
DC,2010,0,33717,0,71,0,24139,0,0,0,57927,109,1118,2487.1,25.71,109,59045
DE,2010,0,56086,0,30253,0,100897,0,0,0,187236,3834,7751,3841.6,22.8,3834,194987
FL,2010,12645,1180462,0,637416,10307,1715374,250178,250178,273130,3783430,230248,289743,60734.6,22.02,503378,4073173
GA,2010,0,540943,0,767906,0,1052237,350268,350268,350268,2711354,220521,247287,38095.8,18.31,570789,2958641
HI,2010,0,161,0,17117,0,262031,0,0,0,279309,15221,18177,6199.8,29.12,15221,297486
IA,2010,0,278751,0,493794,0,417223,46518,46518,46518,1236286,618615,335054,14727.2,15.37,665133,1571340
ID,2010,0,85075,0,8527,0,161121,0,0,0,254723,133887,132245,5777.9,17.18,133887,386968
IL,2010,2191,962240,767419,1069037,52589,1204917,1005374,1005374,1827573,4241568,298292,216383,45198.7,17.25,2125865,4457951
IN,2010,6884,577423,790889,1449371,10643,719848,0,0,808416,2746642,205601,148291,27360.1,15,1014017,2894933
KS,2010,370711,280413,3069,359908,234726,348037,99876,99876,708382,1088234,103509,75257,11614.9,17.58,811891,1163491
KY,2010,145590,239057,2556093,1009823,14610,644203,0,0,2716293,1893083,70808,84515,20414.9,17.22,2787101,1977598
LA,2010,2419335,1482948,54346,259750,392022,1961488,194818,194818,3060521,3899004,113294,134463,40658.6,14.82,3173815,4033467
MA,2010,0,447428,0,83850,0,587698,61853,61853,61853,1180829,50619,75267,24780.2,23.25,112472,1256096
MD,2010,44,217625,58798,266067,0,498084,146265,146265,205107,1128041,48677,71889,21737.2,22.7,253784,1199930
ME,2010,0,80988,0,2279,0,189831,0,0,0,273098,159000,163927,6289.8,18.72,159000,437025
MI,2010,137245,758696,0,749285,40484,814514,309636,309636,487365,2632131,148432,160224,34657.3,18.31,635797,2792355
MN,2010,0,427186,0,315438,0,589241,140873,140873,140873,1472738,291070,224987,20894,17.04,431943,1697725
MO,2010,0,282123,9816,801625,847,645915,94027,94027,104690,1823690,102435,100761,23035.1,18.73,207125,1924451
MS,2010,102998,444875,41586,148463,139090,379283,100791,100791,384465,1073412,63661,74760,12900.2,17.94,448126,1148172
MT,2010,90618,72888,797035,203339,146926,171656,0,0,1034579,447883,114782,117221,4766.1,18.25,1149361,565104
NC,2010,0,308710,0,749091,0,875156,425810,425810,425810,2358767,158386,189830,34287.7,20.16,584196,2548597
ND,2010,107687,64263,377669,409684,652819,148277,0,0,1138175,622224,109146,84009,4374.5,13.23,1247321,706233
NE,2010,2240,169608,0,254552,13520,243230,115540,115540,131300,782930,280420,133695,8788.1,16.74,411720,916625
NH,2010,0,62612,0,33827,0,148187,114032,114032,114032,358658,45146,51207,5298.1,24.16,159178,409865
NJ,2010,0,671005,0,71961,0,919715,342526,342526,342526,2005207,37069,74011,35475.6,21.66,379595,2079218
NM,2010,1453109,246201,381448,267474,380300,226019,0,0,2214857,739694,33674,39926,7300.9,20.09,2248531,779620
NV,2010,4,267808,0,80228,2471,282396,0,0,2475,630432,48915,56443,10209.8,20.87,51390,686875
NY,2010,36601,1224484,0,167094,2210,1485219,437620,437620,476431,3314417,366290,405824,64479.5,22.78,842721,3720241
OH,2010,80778,810593,644947,1355137,27678,1091310,165192,165192,918595,3422232,125530,129218,44137.3,18.11,1044125,3551450
OK,2010,2067225,697351,17580,346047,407137,523822,0,0,2491942,1567220,96019,108361,16989.2,17.13,2587961,1675581
OR,2010,1428,242914,0,42556,0,342072,0,0,1428,627542,398699,406526,12707.1,19.1,400127,1034068
PA,2010,600932,909259,1485775,1310670,18780,1238775,813462,813462,2918949,4272166,159183,190969,48687.8,19.61,3078132,4463135
RI,2010,0,95710,0,0,0,88739,0,0,0,184449,3723,7178,3688.3,23.62,3723,191627
SC,2010,0,225961,0,404966,0,506026,543379,543379,543379,1680332,115370,134412,18970.9,18.55,658749,1814744
SD,2010,1871,72926,0,39061,9321,114364,0,0,11192,226351,209935,128953,3887.6,17.22,221127,355304
TN,2010,5951,263365,45030,515464,1491,681223,289930,289930,342402,1749982,166480,176941,25589.3,18.66,508882,1926923
TX,2010,7549424,3689581,538258,1568060,2475249,5394188,432036,432036,10994967,11083865,389925,458187,136163.2,17.39,11384892,11542052
UT,2010,465967,229078,445692,356148,143045,258718,0,0,1054704,843944,17677,22771,8405.8,17.03,1072381,866715
VA,2010,151378,385768,564326,346161,70,844391,277729,277729,993503,1854049,110819,143772,30698.7,19.13,1104322,1997821
VT,2010,0,8501,0,0,0,81464,49986,49986,49986,139951,32420,34817,2795.8,23.67,82406,174768
WA,2010,0,294871,0,94934,0,691874,96588,96588,96588,1178267,822182,839885,22299.5,18.42,918770,2018152
WI,2010,0,376627,0,458442,0,528503,138812,138812,138812,1502384,204256,186264,21680.1,18.46,343068,1688648
WV,2010,301043,121780,3346117,848129,10684,203955,0,0,3657844,1173864,45978,52218,8182.2,17.43,3703822,1226082
WY,2010,2512933,154759,7658286,484239,312562,166451,0,0,10483781,805449,44768,45955,4599.5,15.37,10528549,851404
US,2010,24592827,24568039,21831301,20828382,11610469,35321018,8434433,8434433,66469030,89151872,8312486,8265583,1214277.5,18.92,74781516,97417455
AK,2011,405691,339819,33524,15481,1188008,268848,0,0,1627223,624148,16078,16702,7829,25.22,1643301,640850
AL,2011,225570,609288,468671,651032,48563,521337,411822,411822,1154626,2193479,255849,279972,24444.2,20.06,1410475,2473451
AR,2011,1090851,288906,2985,306119,46040,337961,148531,148531,1288407,1081517,124986,135133,14194.2,19.59,1413393,1216650
AZ,2011,171,293134,174841,459909,215,552991,327292,327292,502519,1633326,111992,129110,23656.7,25.23,614511,1762436
CA,2011,280255,2196252,0,55264,1137798,3174345,383644,383644,1801697,5809505,834579,953565,133412.9,24.55,2636276,6763070
CO,2011,1822749,477208,586847,368871,229199,463660,0,0,2638795,1309739,106167,107753,19453.3,21.32,2744962,1417492
CT,2011,0,236016,0,6081,0,317397,166669,166669,166669,726163,30742,43360,15619.4,28.16,197411,769523
DC,2011,0,33389,0,48,0,22226,0,0,0,55663,276,1296,2443.3,26.61,276,56959
DE,2011,0,81710,0,17881,0,114686,0,0,0,214277,4154,7844,4279,25.1,4154,222121
FL,2011,15352,1235953,0,552730,11733,1610356,230369,230369,257454,3629408,227695,288638,68671.7,25.46,485149,3918046
GA,2011,0,531596,0,634756,0,1016118,338052,338052,338052,2520522,218510,246831,43577.6,21.62,556562,2767353
HI,2011,0,158,0,16080,0,266019,0,0,0,282257,16593,20402,8067.9,37.15,16593,302659
IA,2011,0,277576,0,463138,0,415548,54572,54572,54572,1210834,668883,353478,16995.8,17.8,723455,1564312
ID,2011,0,83947,0,7846,0,157999,0,0,0,249792,178551,177760,6709.9,19.72,178551,427552
IL,2011,3600,986310,864228,1052224,53116,1182982,1002694,1002694,1923638,4224210,313508,233916,50813.4,19.4,2237146,4458126
IN,2011,9184,635117,840986,1333442,11525,710963,0,0,861695,2679522,222940,156049,32160.5,17.82,1084635,2835571
KS,2011,355019,285318,840,346521,240700,328517,76585,76585,673144,1036941,108558,81476,13203.6,20.36,781702,1118417
KY,2011,134060,229048,2623804,1010623,13491,630806,0,0,2771355,1870477,78515,90457,23866.3,20.62,2849870,1960934
LA,2011,3233225,1535704,52440,269993,401812,1949628,173859,173859,3861336,3929184,119653,135127,47663.9,17.49,3980989,4064311
MA,2011,0,464018,0,42963,0,574191,53212,53212,53212,1134384,53063,77232,27798.4,26.14,106275,1211616
MD,2011,35,199132,65871,241190,0,480594,150655,150655,216561,1071571,57772,80305,23551,25.42,274333,1151876
ME,2011,0,75061,0,1542,0,188435,0,0,0,265038,161563,166773,7396.4,21.87,161563,431811
MI,2011,143529,787337,0,691150,40820,796407,344155,344155,528504,2619049,162097,176632,39718.4,20.73,690601,2795681
MN,2011,0,424958,0,315604,0,580208,125134,125134,125134,1445904,310097,241621,24229.7,19.84,435231,1687525
MO,2011,0,275308,10075,825650,684,623832,98062,98062,108821,1822852,103118,96371,26512.2,22.26,211939,1919223
MS,2011,99589,437873,28822,107546,139449,369063,108164,108164,376024,1022646,66402,75576,14547.9,20.73,442426,1098222
MT,2011,77669,79470,746650,165687,140099,177760,0,0,964418,422917,140362,143494,5749.1,21.79,1104780,566411
NC,2011,0,311189,0,624783,0,830733,424073,424073,424073,2190778,156885,188541,37825,23.29,580958,2379319
ND,2011,130722,72247,367624,394771,884129,184822,0,0,1382475,651840,132334,102733,6399.3,17.13,1514809,754573
NE,2011,1981,173657,0,285384,14755,231425,72549,72549,89285,763015,297829,144549,10040.9,19.33,387114,907564
NH,2011,0,72778,0,24489,0,147637,87508,87508,87508,332412,46132,52027,6166.4,27.72,133640,384439
NJ,2011,0,677521,0,49592,0,931578,351658,351658,351658,2010349,38479,74190,39814.7,24.33,390137,2084539
NM,2011,1397252,251838,405952,284737,414804,232633,0,0,2218008,769208,36007,43298,8906.6,23.81,2254015,812506
NV,2011,3,255970,0,62701,2366,267077,0,0,2369,585748,50243,58036,11085.8,23.35,52612,643784
NY,2011,31902,1247757,0,125181,2175,1387352,446761,446761,480838,3207051,399587,438840,69658.9,25.3,880425,3645891
OH,2011,81303,848771,679187,1222606,27011,1067554,155806,155806,943307,3294737,139196,138111,49386.1,20.43,1082503,3432848
OK,2011,2153980,676910,19094,378320,475728,507576,0,0,2648802,1562806,100945,114750,19383.7,19.73,2749747,1677556
OR,2011,1372,203607,0,35135,0,331023,0,0,1372,569765,517321,526732,14791.9,22.12,518693,1096497
PA,2011,1374471,1000507,1511491,1212984,19900,1208894,796798,796798,3702660,4219183,178878,215431,55660.6,22.72,3881538,4434614
RI,2011,0,102465,0,0,0,82254,0,0,0,184719,3674,6901,3901.8,26.18,3674,191620
SC,2011,0,235465,0,366160,0,485250,553573,553573,553573,1640448,117505,135879,21439,21.4,671078,1776327
SD,2011,1857,73973,0,32112,9477,112687,0,0,11334,218772,234103,154349,4613.5,20.45,245437,373121
TN,2011,5638,267929,38576,481127,1717,673366,281682,281682,327613,1704104,178951,191304,29718.9,22.05,506564,1895408
TX,2011,8014144,3800578,605290,1695239,3072915,5393262,414881,414881,12107230,11303960,445552,524901,162238,20.49,12552782,11828861
UT,2011,496623,230672,453869,346181,152401,276715,0,0,1102893,853568,24384,31282,10545.2,20.29,1127277,884850
VA,2011,155174,383436,562805,288348,64,795625,267334,267334,985377,1734743,104935,136050,34392.7,22.3,1090312,1870793
VT,2011,0,8677,0,0,0,79938,51351,51351,51351,139966,30553,33019,3252.2,27.92,81904,172985
WA,2011,0,272261,0,56951,0,694946,50293,50293,50293,1074451,1063523,1080055,26723,21.48,1113816,2154506
WI,2011,0,399247,0,447370,0,516508,120962,120962,120962,1484087,208295,186444,24669.1,20.91,329257,1670531
WV,2011,442561,124935,3321102,822645,12447,199665,0,0,3776110,1147245,47219,53542,9368.9,20.53,3823329,1200787
WY,2011,2375342,161776,7591675,467671,316187,168323,0,0,10283204,797770,60357,61810,5577.8,18.2,10343561,859580
US,2011,26409448,24953771,22057248,19663856,12012299,34639718,8268698,8268698,68747693,87526043,9305589,9209646,1392467.9,21.87,78053282,96735689
AK,2012,399421,347228,31332,15521,1115926,250063,0,0,1546679,612812,17796,17831,7577.2,25.58,1564475,630643
AL,2012,229914,677380,488084,547004,55245,513993,427975,427975,1201218,2166352,242204,265964,24117.9,19.86,1443422,2432316
AR,2012,1164000,300572,2077,296732,38303,321213,162353,162353,1366733,1080870,114236,125377,13724.9,19.84,1480969,1206247
AZ,2012,119,339043,161374,420570,302,538460,334636,334636,496431,1632709,97645,114315,23910.3,26.03,594076,1747024
CA,2012,278232,2456371,0,43832,1143824,3079327,193939,193939,1615995,5773469,700597,818490,134569.5,25.17,2316592,6591959
CO,2012,1895207,456471,629645,370085,288608,458509,0,0,2813460,1285065,105522,108351,19424.3,21.84,2918982,1393416
CT,2012,0,236260,0,9290,0,300595,178959,178959,178959,725104,26888,38975,15196.5,28.63,205847,764079
DC,2012,0,29389,0,77,0,19354,0,0,0,48820,269,1077,2208,25.43,269,49897
DE,2012,0,104421,0,17384,0,108981,0,0,0,230786,3558,7116,4248.7,24.63,3558,237902
FL,2012,785,1348390,0,482984,12383,1549928,187259,187259,200427,3568561,223004,287354,67903.9,25.56,423431,3855915
GA,2012,0,624338,0,435546,0,956122,355674,355674,355674,2371680,206750,237974,41659,21.83,562424,2609654
HI,2012,0,187,0,16572,0,259024,0,0,0,275783,18095,21430,8289.5,38.6,18095,297213
IA,2012,0,266283,0,422595,0,392006,45552,45552,45552,1126436,677165,370566,16020.3,17.68,722717,1497002
ID,2012,0,90339,0,5186,0,153915,0,0,0,249440,156516,156600,6796,20.28,156516,406040
IL,2012,2148,939024,1094204,969294,56451,1140419,1010189,1010189,2162992,4058926,325074,242375,47680.2,19.19,2488066,4301301
IN,2012,8920,654528,826842,1193465,13630,683759,0,0,849392,2531752,197461,144690,31977.9,18.14,1046853,2676442
KS,2012,334965,268086,388,307585,253756,329269,86818,86818,675927,991758,113448,90046,13106.6,20.98,789375,1081804
KY,2012,118611,232701,2193276,909705,18548,619187,0,0,2330435,1761593,68400,80329,22986,20.65,2398835,1841922
LA,2012,3052087,1585876,53041,238811,411841,1806173,164092,164092,3681061,3794952,115934,130783,39711.8,15.12,3796995,3925735
MA,2012,0,430920,0,24036,0,536809,61402,61402,61402,1053167,49832,73171,26812.4,26.85,111234,1126338
MD,2012,46,216558,54088,192334,0,470103,142297,142297,196431,1021292,48798,71341,22970.8,25.63,245229,1092633
ME,2012,0,70451,0,1299,0,170117,0,0,0,241867,157339,162608,7086.6,21.88,157339,404475
MI,2012,135076,804084,0,621633,43204,778608,293619,293619,471899,2497944,162374,179593,39184,21.33,634273,2677537
MN,2012,0,430277,0,257875,0,585141,125159,125159,125159,1398452,306232,246583,24004.4,20.07,431391,1645035
MO,2012,0,258945,9197,768297,1015,599722,112317,112317,122529,1739281,91803,84689,25775.7,22.6,214332,1823970
MS,2012,65344,499946,30537,82456,139995,373429,76456,76456,312332,1032287,79602,88539,14529.5,20.56,391934,1120826
MT,2012,70814,75234,660148,157308,153665,173248,0,0,884627,405790,124376,127819,5621.8,22,1009003,533609
NC,2012,0,367948,0,534713,0,802771,412722,412722,412722,2118154,153134,186574,37440.4,23.72,565856,2304728
ND,2012,231489,71873,366826,406344,1405653,199212,0,0,2003968,677429,127540,99508,6966.4,17.98,2131508,776937
NE,2012,1353,161770,0,272587,17545,233031,60795,60795,79693,728183,273441,132976,10170.8,19.9,353134,861159
NH,2012,0,74336,0,14191,0,138269,85814,85814,85814,312610,44615,50256,5986.5,28.38,130429,362866
NJ,2012,0,670827,0,25589,0,884720,346962,346962,346962,1928098,42925,76886,37651.4,24.4,389887,2004984
NM,2012,1367017,249815,409050,263439,496196,233394,0,0,2272263,746648,37490,45164,8994.9,24.19,2309753,791812
NV,2012,4,281432,0,52850,2134,261495,0,0,2138,595777,56544,63674,11223.8,23.72,58682,659451
NY,2012,27243,1260950,0,72914,2100,1341448,427277,427277,456620,3102589,360110,399747,67387,25.39,816730,3502336
OH,2012,87405,869556,642149,1019140,29713,1045080,179055,179055,938322,3112831,140309,143509,48072,20.49,1078631,3256340
OK,2012,2295025,712411,22004,327089,585794,522769,0,0,2902823,1562269,119646,135556,19605.4,20.19,3022469,1697825
OR,2012,787,220578,0,28259,0,323741,0,0,787,572578,498462,507768,14892.2,22.58,499249,1080346
PA,2012,2368982,1079495,1390644,1093178,25050,1157559,787753,787753,4572429,4117985,168572,203830,54045,22.76,4741001,4321815
RI,2012,0,98435,0,0,0,78856,0,0,0,177291,2951,6003,3828.2,26.58,2951,183294
SC,2012,0,250481,0,298572,0,468285,535952,535952,535952,1553290,119713,138964,21123.7,21.83,655665,1692254
SD,2012,15413,71501,0,35574,10173,116746,0,0,25586,223821,217380,140762,4768.5,21.03,242966,364583
TN,2012,6624,281007,28372,423086,2152,646741,263045,263045,300193,1613879,166373,181037,28637,22.26,466566,1794916
TX,2012,8523892,3964124,578697,1498818,4210452,5504726,402823,402823,13715864,11370491,461642,533395,152502,19.16,14177506,11903886
UT,2012,534130,232630,387129,322055,175218,269396,0,0,1096477,824081,21011,28026,10614,21.15,1117488,852107
VA,2012,151383,424000,493398,222270,52,796113,300992,300992,945825,1743375,102365,134372,34741.6,22.73,1048190,1877747
VT,2012,0,8287,0,0,0,75387,52283,52283,52283,135957,26305,28836,3212.9,29.07,78588,164793
WA,2012,0,271947,0,42656,0,697816,97808,97808,97808,1110227,1019829,1036980,26878,21.77,1117637,2147207
WI,2012,0,410305,0,373281,0,501822,149845,149845,149845,1435253,199575,178205,24202,21.34,349420,1613458
WV,2012,602587,140133,3059090,756716,14923,194403,0,0,3676600,1091252,44877,51398,9173.2,21.19,3721477,1142650
WY,2012,2240497,158546,6973727,490128,335286,172121,0,0,9549510,820795,53775,55484,5789.2,18.68,9603285,876279
US,2012,27872427,26075691,20585319,17380923,13848648,33833375,8061822,8061822,70368216,85351811,8889503,8852895,1355174.7,21.84,79257719,94204706
AK,2013,380655,332631,24917,14819,1089953,230765,0,0,1495525,578215,18629,18931,6957.4,25.11,1514154,597146
AL,2013,211258,625869,469162,565051,60366,492294,426488,426488,1167274,2109702,313682,336863,23972.2,18.89,1480956,2446565
AR,2013,1164319,288045,1433,327099,38680,321254,124816,124816,1329248,1061214,121335,132370,14004.7,19.3,1450583,1193584
AZ,2013,74,340375,163691,454865,348,543380,328423,328423,492536,1667043,99051,119753,23907.4,25.7,591587,1786796
CA,2013,287883,2480792,0,38151,1153782,3096230,187162,187162,1628827,5802335,743306,897358,135749.7,25.15,2372133,6699693
CO,2013,1799439,480875,529096,363532,384070,464287,0,0,2712605,1308694,119366,122946,19887.4,21.18,2831971,1431640
CT,2013,0,240102,0,7679,0,307661,178465,178465,178465,733907,30055,42952,15331.2,27.79,208520,776859
DC,2013,0,33725,0,4,0,18790,0,0,0,52519,309,1179,2218.3,24.71,309,53698
DE,2013,0,100682,0,18254,0,101393,0,0,0,220329,3803,7619,3975.1,24.05,3803,227948
FL,2013,297,1245287,0,505155,12609,1588920,277169,277169,290075,3616531,234151,301827,67935.3,25.11,524226,3918358
GA,2013,0,634635,0,426184,0,975666,343801,343801,343801,2380286,248877,284011,42706.8,21.46,592678,2664297
HI,2013,0,197,0,15306,0,260346,0,0,0,275849,22775,25989,8214.8,37.07,22775,301838
IA,2013,0,306419,0,402402,0,415110,55597,55597,55597,1179528,705183,389728,16792.6,17.22,760780,1569256
ID,2013,0,107089,0,7965,0,157372,0,0,0,272426,140184,140544,7068.8,20.24,140184,412970
IL,2013,2933,1063511,1149607,1026925,55326,1169110,1014926,1014926,2222792,4274472,355728,268752,48730.1,18.37,2578520,4543224
IN,2013,8057,680051,883260,1198611,13914,721544,0,0,905231,2600206,213708,157896,33172.4,17.97,1118939,2758102
KS,2013,321465,288274,541,326817,271707,338696,74902,74902,668615,1028689,154217,132989,13785.4,21.15,822832,1161678
KY,2013,106732,235703,1940060,914774,13369,582930,0,0,2060161,1733407,80673,96473,22728.8,20.8,2140834,1829880
LA,2013,2463608,1504969,38079,228055,418847,1762715,177156,177156,3097690,3672895,140427,151598,39313.3,15.27,3238117,3824493
MA,2013,0,435312,0,42208,0,564699,45251,45251,45251,1087470,57090,82560,28062.5,26.49,102341,1170030
MD,2013,33,206126,45290,183191,0,478356,149048,149048,194371,1016721,53544,78496,23324,25.35,247915,1095217
ME,2013,0,65886,0,1657,0,182365,0,0,0,249908,161720,168347,7432.1,21.71,161720,418255
MI,2013,129758,831741,0,658172,45176,831484,302194,302194,477128,2623591,188731,208916,40772,20.31,665859,2832507
MN,2013,0,478611,0,267695,0,600937,111885,111885,111885,1459128,305832,245622,25168.8,19.74,417717,1704750
MO,2013,9,281399,9101,806549,1154,601720,87428,87428,97692,1777096,110069,97726,26500.5,22.31,207761,1874822
MS,2013,60866,426902,37197,97767,139531,364610,113523,113523,351117,1002802,64706,76908,14601.2,21.12,415823,1079710
MT,2013,67877,82298,753246,166104,169870,172419,0,0,990993,420821,114500,118144,5622.4,22.06,1105493,538965
NC,2013,0,445018,0,493771,0,812705,420486,420486,420486,2171980,192360,228352,38054.4,23.37,612846,2400332
ND,2013,318391,82334,369479,393193,1811624,222215,0,0,2499494,697742,125386,98237,7657.3,18.31,2624880,795979
NE,2013,1069,179617,0,292956,16286,231611,71736,71736,89091,775920,278161,138417,10319.4,19.34,367252,914337
NH,2013,0,55649,0,16778,0,144512,114173,114173,114173,331112,52904,59059,6144.5,27.68,167077,390171
NJ,2013,0,711999,0,25910,0,878077,348784,348784,348784,1964770,49729,86152,37567,23.84,398513,2050922
NM,2013,1331404,252867,400228,256377,596176,232460,0,0,2327808,741704,39674,46411,9071.8,23.62,2367482,788115
NV,2013,3,282245,0,64838,1937,268244,0,0,1940,615327,66544,74096,11296.3,22.81,68484,689423
NY,2013,24232,1315282,0,68707,2123,1330482,467651,467651,494006,3182122,380811,418075,68137.6,24.72,874817,3600197
OH,2013,175320,945731,612270,1104486,46620,1053987,168451,168451,1002661,3272655,155525,160117,48589.3,19.88,1158186,3432772
OK,2013,2282057,682277,25054,335925,722912,506028,0,0,3030023,1524230,164988,178059,19298.8,19.73,3195011,1702289
OR,2013,782,244265,0,38900,0,322313,0,0,782,605478,463420,472016,14841,22.04,464202,1077494
PA,2013,3452918,1175535,1379262,1126118,30757,1181000,822483,822483,5685420,4305136,200385,235207,54600,21.53,5885805,4540343
RI,2013,0,88274,0,0,0,82166,0,0,0,170440,2704,6106,3991.6,26.23,2704,176546
SC,2013,0,236942,0,257319,0,480197,566879,566879,566879,1541337,134299,156589,21813.3,21.96,701178,1697926
SD,2013,16753,84527,0,34246,10730,112656,0,0,27483,231429,208561,128968,4768,20.24,236044,360397
TN,2013,6240,284750,28376,399768,1937,655891,297732,297732,334285,1638141,210044,226381,28975.3,21.64,544329,1864522
TX,2013,8825436,4131225,564850,1597357,5384476,5828991,400353,400353,15175115,11957926,500607,584228,158435.4,18.99,15675722,12542154
UT,2013,516190,258661,385736,355230,203093,271571,0,0,1105019,885462,17181,25011,10936.6,20.66,1122200,910473
VA,2013,144400,433438,456766,290508,58,793774,306430,306430,907654,1824150,118392,152518,34734,22.12,1026046,1976668
VT,2013,0,9743,0,0,0,78655,50639,50639,50639,139037,33315,36145,3313.2,28.28,83954,175182
WA,2013,0,327840,0,74955,0,698425,88408,88408,88408,1189628,928039,942926,26479.2,21.53,1016447,2132554
WI,2013,0,454050,0,454554,0,510487,121994,121994,121994,1541085,206356,188808,24877.7,20.27,328350,1729893
WV,2013,832674,152880,2874653,771188,41986,195225,0,0,3749313,1119293,53863,61073,9175.9,20.63,3803176,1180366
WY,2013,2050835,156110,6760447,520699,368172,161686,0,0,9179454,838495,53125,54820,5545.8,18.42,9232579,893315
US,2013,28421429,26788768,19901802,18038771,15871833,34398415,8244433,8244433,72439497,87470387,9438028,9464268,1376402.2,21.42,81877525,96934655
AK,2014,381937,329274,22944,18225,1050554,226102,0,0,1455435,573601,19788,22760,6875.7,24.95,1475223,596361
AL,2014,195614,650570,414366,575912,57020,490328,431368,431368,1098368,2148178,270744,293890,24079.7,18.62,1369112,2442068
AR,2014,1142667,273009,1864,339214,39295,325319,151428,151428,1335254,1088970,119827,131625,13916.4,18.86,1455081,1220595
AZ,2014,109,315916,173337,447849,325,543552,338044,338044,511815,1645361,120267,139836,23613.1,25.51,632082,1785197
CA,2014,271757,2409574,0,39486,1187643,3083503,177656,177656,1637056,5710219,750692,903692,136011.3,25.65,2387748,6613911
CO,2014,1848761,497182,528242,350526,554834,480827,0,0,2931837,1328535,126925,131177,20433.4,21.33,3058762,1459712
CT,2014,0,242227,0,9097,0,308514,165677,165677,165677,725515,32675,45472,15590.1,27.96,198352,770987
DC,2014,0,35302,0,48,0,20118,0,0,0,55468,344,1313,2325.7,24.92,344,56781
DE,2014,0,107051,0,10238,0,103067,0,0,0,220356,4224,8064,3994,23.68,4224,228420
FL,2014,858,1241250,0,557882,12917,1613839,291474,291474,305249,3704445,231320,298010,68555.7,24.99,536569,4002455
GA,2014,0,664808,0,482657,0,948453,340652,340652,340652,2436570,267186,297134,42586,21.14,607838,2733704
HI,2014,0,167,0,17241,0,250169,0,0,0,267577,24423,27996,7769.9,36.24,24423,295573
IA,2014,0,311352,0,401151,0,424219,43431,43431,43431,1180153,726955,406807,17467.7,17.64,770386,1586960
ID,2014,0,93610,0,7472,0,162438,0,0,0,263520,156026,155787,7145.6,20.64,156026,419307
IL,2014,2044,1108134,1293541,1017855,55367,1197140,1023496,1023496,2374448,4346625,368785,278073,51697.8,18.88,2743233,4624698
IN,2014,6742,723942,886370,1221492,14541,734901,0,0,907653,2680335,226986,162947,33963.9,18.05,1134639,2843282
KS,2014,317646,291483,1474,316572,287204,356192,89512,89512,695836,1053759,179678,151818,14500.1,21.21,875514,1205577
KY,2014,105319,262278,1869335,913452,15231,580146,0,0,1989885,1755876,81704,96645,22224.6,20.43,2071589,1852521
LA,2014,2068200,1547176,35541,209973,401203,1698933,181059,181059,2686003,3637141,169820,173371,39452.9,15.12,2855823,3810512
MA,2014,0,432523,0,29871,0,563978,60340,60340,60340,1086712,62217,87252,28161.3,26.51,122557,1173964
MD,2014,21,217227,46194,201220,0,484711,150017,150017,196232,1053175,53164,77492,23493.6,25.12,249396,1130667
ME,2014,0,62423,0,2142,0,185791,0,0,0,250356,157449,164138,7571.3,22.72,157449,414494
MI,2014,120152,878128,0,618479,43065,847600,326800,326800,490017,2671007,202663,221483,40786.7,19.84,692680,2892490
MN,2014,0,490111,0,313073,0,602446,132904,132904,132904,1538534,340458,273992,25728,19.6,473362,1812526
MO,2014,3,301368,8206,780707,1137,614721,97021,97021,106367,1793817,113126,98934,26626.3,21.72,219493,1892751
MS,2014,56686,439557,39072,116537,141491,367502,107228,107228,344477,1030824,64569,78055,14935.6,20.97,409046,1108879
MT,2014,63185,80063,790673,175357,173397,168456,0,0,1027255,423876,134132,137730,5575.7,21.86,1161387,561606
NC,2014,0,462289,0,501592,0,834289,428474,428474,428474,2226644,173981,209090,38436.3,23.11,602455,2435734
ND,2014,437170,89095,389673,399195,2288796,236320,0,0,3115639,724610,138427,111219,8219.4,18.38,3254066,835829
NE,2014,435,179705,0,276544,17690,234466,105655,105655,123780,796370,307736,155904,10356.8,19.26,431516,952274
NH,2014,0,58785,0,14867,0,155001,106350,106350,106350,335003,55536,61731,6443,27.78,161886,396734
NJ,2014,0,805145,0,30731,0,856154,329533,329533,329533,2021563,54087,91005,37180,23.14,383620,2112568
NM,2014,1397847,256056,400158,215348,725354,240408,0,0,2523359,711812,41707,48148,9213.6,23.69,2565066,759960
NV,2014,3,261902,0,79230,1833,275622,0,0,1836,616754,67511,76197,11516.3,23.17,69347,692951
NY,2014,20847,1392378,0,64655,2065,1382080,450141,450141,473053,3289254,397898,437667,70093.4,24.49,870951,3726921
OH,2014,590622,1058802,541830,1057377,87528,1062667,170319,170319,1390299,3349165,167121,163389,50278,19.76,1557420,3512554
OK,2014,2669289,667360,20607,336080,872900,535307,0,0,3562796,1538747,163016,177919,20395.4,19.92,3725812,1716666
OR,2014,1175,226472,0,34238,0,325766,0,0,1175,586476,485321,495029,14802.8,22.11,486496,1081505
PA,2014,4521340,1304080,1566449,1039161,39724,1207164,823277,823277,6950790,4373682,197387,232509,55800.9,21.29,7148177,4606191
RI,2014,0,91374,0,0,0,86353,0,0,0,177727,4421,7902,4218.1,26.58,4421,185629
SC,2014,0,236040,0,305656,0,479576,548246,548246,548246,1569518,136998,158548,22132.2,21.91,685244,1728066
SD,2014,15968,83919,0,33062,10428,114520,0,0,26396,231501,221729,140135,4877.4,20.37,248125,371636
TN,2014,6010,313887,21711,427509,1914,672629,289401,289401,319036,1703426,178923,194804,29650.5,21.4,497959,1898230
TX,2014,9366356,4060590,576803,1585961,6728563,5803534,410907,410907,17082629,11860992,545598,634054,160438.6,18.84,17628227,12495046
UT,2014,501322,251649,410997,344054,237272,274435,0,0,1149591,870138,22233,29679,10856.2,21.01,1171824,899817
VA,2014,139809,438697,393225,278183,81,830111,316081,316081,849196,1863072,135885,167411,35309.3,21.78,985081,2030483
VT,2014,0,10853,0,0,0,79824,52929,52929,52929,143606,32830,35555,3305.1,27.7,85759,179161
WA,2014,0,320167,0,76547,0,681853,99332,99332,99332,1177899,940851,957292,25674.1,21.17,1040183,2135191
WI,2014,0,479396,0,417096,0,543179,98807,98807,98807,1538478,216590,195664,26491.1,20.66,315397,1734142
WV,2014,1246092,180222,2858022,816460,59914,193011,0,0,4164028,1189693,50017,57169,9021,20.08,4214045,1246862
WY,2014,1982353,142268,6880205,489300,441328,171012,0,0,9303886,802580,54140,56015,5863.4,18.79,9358026,858595
US,2014,30872950,27376838,20170837,17996577,18615622,34658248,8337559,8337559,77996968,88369222,9797648,9761070,1395430.4,21.33,87794616,98130292
AK,2015,380887,333936,17747,19511,1007501,235839,0,0,1406135,589286,23798,23819,5552.3,19.06,1429933,613105
AL,2015,182481,701582,331420,494311,55421,511742,438728,438728,1008050,2146363,258906,284365,19990.1,15.69,1266956,2430728
AR,2015,1031466,296826,1819,226889,35611,314414,144716,144716,1213612,982845,117822,129264,11171.7,15.86,1331434,1112109
AZ,2015,99,365313,146450,385822,212,557369,340153,340153,486914,1648657,128895,149031,20744.8,21.89,615809,1797688
CA,2015,271086,2384061,0,30967,1150741,3201112,193529,193529,1615356,5809669,737985,911138,120161.2,22.14,2353341,6720807
CO,2015,1965188,490642,403605,340107,698595,479850,0,0,3067388,1310599,126538,133682,16387.9,17.21,3193926,1444281
CT,2015,0,260925,0,6536,0,313997,182083,182083,182083,763541,33232,46764,13126.1,23.3,215315,810305
DC,2015,0,33654,0,44,0,20423,0,0,0,54121,824,1831,2144.8,23.11,824,55952
DE,2015,0,107819,0,7149,0,109009,0,0,0,223977,3516,7744,3485.9,19.74,3516,231721
FL,2015,1162,1378089,0,466530,12623,1695087,294099,294099,307884,3833805,223760,293757,57721.4,20.22,531644,4127562
GA,2015,0,712580,0,394665,0,997508,353883,353883,353883,2458636,269498,300896,34957.9,17.1,623381,2759532
HI,2015,0,196,0,15632,0,254200,0,0,0,270028,24949,29420,5906.4,27.11,24949,299448
IA,2015,0,302936,0,348293,0,415141,54836,54836,54836,1121206,766767,429835,13413.7,13.93,821603,1551041
ID,2015,1192,107871,0,4249,172,175254,0,0,1364,287374,153447,154481,6132.7,16.87,154811,441855
IL,2015,2210,1011357,1252879,850430,54426,1245106,1017377,1017377,2326892,4124270,355305,270570,40674.6,15.54,2682197,4394840
IN,2015,7446,735055,776493,1007472,12686,750409,0,0,796625,2492936,242116,173327,27479.6,14.99,1038741,2666263
KS,2015,318548,280421,4387,273416,260015,340937,90254,90254,673204,985028,177319,149870,11241.5,17.01,850523,1134898
KY,2015,108080,276867,1486019,796484,16362,590257,0,0,1610461,1663608,75302,89402,17478.3,16.37,1685763,1753010
LA,2015,1916410,1594207,46879,174221,364390,1716529,160015,160015,2487694,3644972,154626,158287,27743.2,10.55,2642320,3803259
MA,2015,0,457124,0,24177,0,577821,52236,52236,52236,1111358,62775,88979,24085.8,22.34,115011,1200337
MD,2015,40,225969,45587,165994,0,499114,153140,153140,198767,1044217,47601,73185,19705.1,21.02,246368,1117402
ME,2015,0,54203,0,2588,0,194972,0,0,0,251763,161394,168574,6041.1,17.95,161394,420337
MI,2015,114061,871834,0,617280,37521,864500,306773,306773,458355,2660387,223202,239503,33018.3,16.43,681557,2899890
MN,2015,0,448557,0,271570,0,595108,125900,125900,125900,1441135,345895,278624,19772.5,16.13,471795,1719759
MO,2015,1,270885,3178,696401,852,622945,109182,109182,113213,1699413,105621,95606,21688,18.28,218834,1795019
MS,2015,60476,536996,34528,71626,142485,377952,122511,122511,360000,1109085,60419,74223,12110.3,16.96,420419,1183308
MT,2015,55943,77443,746222,178421,163249,165080,0,0,965414,420944,124959,129412,4384.2,17.66,1090373,550356
NC,2015,0,516026,0,405525,0,857023,440248,440248,440248,2218822,169977,206845,31788.5,19,610225,2425667
ND,2015,678977,100852,392183,408091,2456155,193722,0,0,3527315,702665,141705,109747,5552.9,13.73,3669020,812412
NE,2015,504,170346,0,266319,15419,234270,107976,107976,123899,778911,317134,164543,8165.8,15.54,441033,943454
NH,2015,0,70742,0,10989,0,152764,99186,99186,99186,333681,61334,67603,5285.3,22.56,160520,401284
NJ,2015,0,778866,0,22925,0,877467,347851,347851,347851,2027109,45194,81586,29753.6,18.96,393045,2108695
NM,2015,1436329,260038,357525,215703,846659,237701,0,0,2640513,713442,38796,48909,7238.3,18.65,2679309,762351
NV,2015,4,312602,0,36635,1606,266639,0,0,1610,615876,75331,85212,9664.9,19.43,76941,701088
NY,2015,17879,1396693,0,41241,1635,1383266,466457,466457,485971,3287657,408986,448392,56789.5,19.83,894957,3736049
OH,2015,1171552,1031716,417682,865714,153490,1081188,181726,181726,1924450,3160344,164895,157489,40888.4,16.56,2089345,3317833
OK,2015,2880137,711393,17422,280748,949331,521667,0,0,3846890,1513808,187115,203058,15942.3,16.05,4034005,1716866
OR,2015,889,245897,0,26515,0,323140,0,0,889,595552,438751,451541,12671.7,18.94,439640,1047093
PA,2015,5119772,1313350,1278078,878829,40522,1187148,842044,842044,7280416,4221371,200503,235433,44887.5,17.74,7480919,4456804
RI,2015,0,96514,0,0,0,86112,0,0,0,182626,4886,8469,3578.1,22.6,4886,191095
SC,2015,0,284013,0,241217,0,511425,555909,555909,555909,1592564,128605,151230,18598,18.05,684514,1743794
SD,2015,614,83370,0,19616,9507,115692,0,0,10121,218678,225463,138038,3847.4,16.3,235584,356716
TN,2015,4959,322468,23192,370650,1692,687482,261037,261037,290880,1641637,181970,196878,23962.5,17.44,472850,1838515
TX,2015,9392314,4263856,471257,1340422,7213608,6022376,411571,411571,17488750,12038225,582776,672832,119292.2,13.69,18071526,12711057
UT,2015,461219,242848,325216,330043,212307,276308,0,0,998742,849199,23983,33778,8894.3,17.22,1022725,882977
VA,2015,134220,526314,365832,232427,63,834674,293455,293455,793570,1886870,137583,169053,28475.7,17.67,931153,2055923
VT,2015,0,12245,0,0,0,81888,0,0,0,94133,38777,41531,2692.3,21.34,38777,135664
WA,2015,0,327738,0,58273,0,732667,85347,85347,85347,1204025,871925,891733,21868.1,17.44,957272,2095758
WI,2015,0,476969,0,408189,0,534079,104666,104666,104666,1523903,223862,200490,20771.2,16.97,328528,1724393
WV,2015,1562536,191059,2447181,730949,66157,189690,0,0,4075874,1111698,37940,44994,7249.2,16.88,4113814,1156692
WY,2015,1998295,126421,6538240,487177,494269,158389,0,0,9030804,771987,49864,52372,4447,14.88,9080668,824359
US,2015,32717205,28179686,17931020,15548985,19701840,35368448,8336886,8336886,78686951,87434005,9765932,9749471,1128447.4,17.31,88452883,97183476
AK,2016,369865,330883,13942,16613,1026401,219837,0,0,1410208,567333,25148,26254,4561.4,17,1435356,593587
AL,2016,176290,715033,247632,410168,46417,538953,417334,417334,887673,2081488,230706,259513,19230,14.85,1118379,2341001
AR,2016,839485,315617,974,246437,31580,322808,140370,140370,1012409,1025232,115405,127831,10292.2,14.62,1127814,1153063
AZ,2016,49,373916,116678,323878,46,576213,338636,338636,455409,1612643,138469,162028,19581.3,20.11,593878,1774671
CA,2016,234094,2248939,0,32077,1064744,3315378,197754,197754,1496592,5794148,932965,1116287,111275.5,20.16,2429557,6910435
CO,2016,1981005,464749,270920,321476,663712,482014,0,0,2915637,1268239,149550,158875,15097.4,15.75,3065187,1427114
CT,2016,0,254652,0,2340,0,296001,173363,173363,173363,726356,34246,47868,11748.8,21.89,207609,774224
DC,2016,0,30160,0,34,0,19489,0,0,0,49683,1107,2193,1983.6,22.36,1107,51876
DE,2016,0,113552,0,8199,0,110248,0,0,0,231999,3105,7597,3187.1,18.16,3105,239596
FL,2016,1062,1414358,0,426188,11066,1738523,306658,306658,318786,3885727,223400,290005,53459.1,18.42,542186,4175732
GA,2016,0,727336,0,399279,0,971869,360633,360633,360633,2459117,282316,298214,32344.2,16.16,642949,2757331
HI,2016,0,162,0,16431,0,252070,0,0,0,268663,27586,32368,5215.5,23.95,27586,301031
IA,2016,0,317115,0,298006,0,424923,49185,49185,49185,1089229,801736,452667,12684.6,12.93,850921,1541896
ID,2016,5208,110344,0,2432,1230,176049,0,0,6438,288825,151461,153289,5717.5,15.48,157899,442114
IL,2016,2317,1045034,977131,702467,49432,1247540,1031331,1031331,2060211,4026372,375095,276545,37622.1,14.56,2435306,4302917
IN,2016,6441,779945,654493,948386,10397,726396,0,0,671331,2454727,257436,183792,24910.2,13.78,928767,2638519
KS,2016,281646,276404,617,253121,217116,342440,86245,86245,585624,958210,205743,179062,10522.7,16.02,791367,1137272
KY,2016,102591,279935,1041121,736584,14849,600376,0,0,1158561,1616895,76957,91858,16181.7,15.26,1235518,1708753
LA,2016,1893803,1718305,38499,140513,328632,1700751,179391,179391,2440325,3738960,182727,176181,25055.2,9.33,2623052,3915141
MA,2016,0,440725,0,20115,0,558903,56628,56628,56628,1076371,65604,93041,21535.8,20.61,122232,1169412
MD,2016,36,229508,37859,162931,0,473740,154377,154377,192272,1020556,48227,73766,17893.2,19.85,240499,1094322
ME,2016,0,54509,0,2194,0,186072,0,0,0,242775,141924,150107,5272,16.8,141924,392882
MI,2016,108450,926828,0,471236,32312,880277,329999,329999,470761,2608340,216648,234596,30950.2,15.57,687409,2842936
MN,2016,0,466365,0,261250,0,617809,144970,144970,144970,1490394,351258,282936,18614.1,14.84,496228,1773330
MO,2016,1,273583,5125,639860,704,619747,98630,98630,104460,1631820,105865,94312,19938.8,17.22,210325,1726132
MS,2016,50418,561342,32349,61219,116649,386987,61680,61680,261096,1071228,78133,76967,10942.9,15.43,339229,1148195
MT,2016,52130,77589,572787,161938,132619,166880,0,0,757536,406407,128046,132767,4027.8,15.97,885582,539174
NC,2016,0,540271,0,381761,0,878993,447500,447500,447500,2248525,199488,222384,29950.8,17.63,646988,2470909
ND,2016,766865,105625,399856,394579,2161880,164552,0,0,3328601,664756,162594,125731,4618.8,12.39,3491195,790487
NE,2016,557,172929,0,240465,12560,232829,97798,97798,110915,744021,330900,168536,7557.4,14.31,441815,912557
NH,2016,0,59638,0,5277,0,146737,112551,112551,112551,324203,56283,62838,4718.4,20.97,168834,387041
NJ,2016,0,793928,0,17455,0,888468,312569,312569,312569,2012420,46537,85369,27341.1,17.63,359106,2097789
NM,2016,1422598,259158,246549,197083,839040,235515,0,0,2508187,691756,54803,64769,6475.7,16.83,2562990,756525
NV,2016,3,316653,0,30765,1585,289383,0,0,1588,636801,88551,99674,8753,16.64,90139,736475
NY,2016,13942,1336455,0,29679,1287,1382206,434791,434791,450020,3183131,412865,454021,50926.5,18.1,862885,3637152
OH,2016,1647241,994162,309088,825311,124270,1082887,175893,175893,2256492,3078253,166674,159177,37637.4,15.6,2423166,3237430
OK,2016,2864577,736164,14440,221842,887745,520186,0,0,3766762,1478192,243478,260290,13902,14.06,4010240,1738482
OR,2016,848,249829,0,19440,0,327835,0,0,848,597104,467942,482943,11788.8,17.36,468790,1080047
PA,2016,5525743,1354340,1168609,734838,35888,1138129,867302,867302,7597542,4094609,196747,230921,39790.6,16.63,7794289,4325530
RI,2016,0,88471,0,0,0,74342,0,0,0,162813,4700,8267,3018.2,21.25,4700,171080
SC,2016,0,284225,0,221865,0,522302,583883,583883,583883,1612275,131034,150318,17748.6,17.07,714917,1762593
SD,2016,511,85021,0,26660,8045,113289,0,0,8556,224970,237255,149018,3526,15.01,245811,373988
TN,2016,4180,336341,16596,379775,1471,702677,309357,309357,331604,1728150,154155,170822,22388.5,16.17,485759,1898972
TX,2016,8659990,4151065,515707,1323111,6687279,6175136,440109,440109,16303085,12089421,708954,820815,110577.8,12.53,17012039,12910236
UT,2016,401909,250199,310453,269016,174681,285349,0,0,887043,804564,36548,47601,8396.6,15.76,923591,852165
VA,2016,126663,572103,335590,222938,40,844901,310966,310966,773259,1950908,139800,167391,26281.8,16.26,913059,2118299
VT,2016,0,12383,0,0,0,77727,0,0,0,90110,35631,38701,2404.1,19.91,35631,128811
WA,2016,0,324929,0,53302,0,800690,100674,100674,100674,1279595,930433,948976,21129.8,15.89,1031107,2228571
WI,2016,0,501042,0,357335,0,524098,106173,106173,106173,1488648,224231,200299,19155.2,15.76,330404,1688947
WV,2016,1667404,188491,2041073,751957,43693,199199,0,0,3752170,1139647,39641,47885,7145.2,16.45,3791811,1187532
WY,2016,1878141,132478,5169939,457315,415749,152624,0,0,7463829,742417,54543,58491,3990.8,13.28,7518372,800908
US,2016,32428188,28392790,14538027,14227138,18529003,35712347,8426753,8426753,73921971,86759028,10477348,10408644,1038883.6,15.95,84399319,97167672
AK,2017,382940,343899,14365,16376,1033270,216452,0,0,1430575,576727,23611,24447,5040.3,18.98,1454186,601174
AL,2017,159686,681208,326748,378890,39100,530370,446097,446097,971631,2036565,258502,285081,20444.4,15.97,1230133,2321646
AR,2017,708482,317530,832,267591,30263,321210,132736,132736,872313,1039067,116677,121635,11281.4,15.76,988990,1160702
AZ,2017,58,334629,134024,334512,74,583258,338246,338246,472402,1590645,149421,172736,21227,21.8,621823,1763381
CA,2017,240221,2190994,0,33663,992385,3392689,187227,187227,1419833,5804573,1127237,1314777,123245.3,21.97,2547070,7119350
CO,2017,2028824,462135,320001,315835,743744,489738,0,0,3092569,1267708,153315,162034,16603.3,17.2,3245884,1429742
CT,2017,0,246532,0,2507,0,299249,172570,172570,172570,720858,32884,46758,12562.3,23.18,205454,767616
DC,2017,0,30607,0,30,0,16915,0,0,0,47552,1316,2257,1966.1,23.03,1316,49809
DE,2017,0,103121,0,4804,0,112654,0,0,0,220579,3268,7912,3451.5,19.75,3268,228491
FL,2017,1048,1421271,0,407538,11005,1757690,304840,304840,316893,3891339,236660,306615,58778.2,20.05,553553,4197954
GA,2017,0,709671,0,344273,0,1028148,352560,352560,352560,2434652,274993,293604,35500.7,17.58,627553,2728256
HI,2017,0,163,0,14948,0,262205,0,0,0,277316,26953,32003,5843.1,26.1,26953,309319
IA,2017,0,376298,0,300287,0,409164,54528,54528,54528,1140277,836979,473227,13942.6,13.7,891507,1613504
ID,2017,4192,115899,0,2615,521,176634,0,0,4713,295148,172940,174569,6336.1,16.62,177653,469717
IL,2017,2260,1034583,1079624,685000,47581,1251487,1016522,1016522,2145987,3987592,378543,286646,40718.8,15.86,2524530,4274238
IN,2017,6168,747919,713397,929271,10181,700249,0,0,729746,2377439,260410,183807,26752.3,15.15,990156,2561246
KS,2017,257200,279097,0,216747,205026,335329,111367,111367,573593,942540,248526,219766,11179.3,17.3,822119,1162306
KY,2017,101295,296673,1015108,639356,14176,577856,0,0,1130579,1513885,89626,103410,17352.6,16.72,1220205,1617295
LA,2017,2238355,1716392,27892,142267,295009,1814440,161171,161171,2722427,3834270,170254,161570,29672,10.51,2892681,3995840
MA,2017,0,462406,0,12407,0,561908,52788,52788,52788,1089509,68449,95856,23336,22.04,121237,1185365
MD,2017,34,232723,42804,106973,0,470666,158004,158004,200842,968366,55321,80822,18935.6,21.22,256163,1049188
ME,2017,0,45125,0,2168,0,181420,0,0,0,228713,148008,155506,5593.2,18.24,148008,384219
MI,2017,102619,908197,0,499439,31848,869880,338675,338675,473142,2616191,225883,238177,32708.1,16.5,699025,2854368
MN,2017,0,466884,0,257594,0,611526,145426,145426,145426,1481430,363438,293528,20488.7,16.24,508864,1774958
MO,2017,1,264614,5321,709796,664,611040,86853,86853,92839,1672303,116820,102440,21324.2,18.68,209659,1774743
MS,2017,39719,543721,32019,53779,101772,384318,77027,77027,250537,1058845,71031,71848,11882.3,16.73,321568,1130693
MT,2017,50821,83319,624772,156073,118586,172427,0,0,794179,411819,136183,140885,4591.4,17.17,930362,552704
NC,2017,0,520659,0,350286,0,885764,443192,443192,443192,2199901,215530,240022,31618.3,18.68,658722,2439923
ND,2017,857330,112146,394022,397875,2235427,184122,0,0,3486779,694143,212016,165938,5414.8,13.51,3698795,860081
NE,2017,483,175613,0,233809,11978,233348,72300,72300,84761,715070,355937,186969,8261.5,15.53,440698,902039
NH,2017,0,53633,0,3617,0,152656,104493,104493,104493,314399,59861,66803,5187.4,22.26,164354,381202
NJ,2017,0,734147,0,16488,0,858632,355948,355948,355948,1965215,45589,83836,28988,19.16,401537,2049051
NM,2017,1506770,249357,257710,199114,986519,249356,0,0,2750999,697827,67377,78080,7366.2,18.8,2818376,775907
NV,2017,3,305309,0,27297,1637,306479,0,0,1640,639085,98078,109544,9854.1,17.99,99718,748629
NY,2017,11760,1276905,0,19553,1105,1378849,441029,441029,453894,3116336,447501,490642,55246.9,19.53,901395,3606978
OH,2017,2009410,1014299,233560,810953,113058,1073983,184997,184997,2541025,3084232,167026,156232,39957,16.7,2708051,3240464
OK,2017,2936597,692145,12590,198309,949326,544537,0,0,3898513,1434991,274720,290968,15549.7,15.37,4173233,1725959
OR,2017,700,262532,0,18723,0,335127,0,0,700,616382,501216,516930,13064.7,18.35,501916,1133312
PA,2017,5769945,1404240,1260516,669540,37554,1151732,870187,870187,7938202,4095699,204915,240496,43377.7,17.94,8143117,4336195
RI,2017,0,94730,0,0,0,75184,0,0,0,169914,5966,9567,3213.3,22.29,5966,179481
SC,2017,0,287408,0,192751,0,524166,568390,568390,568390,1572715,132523,152847,18951.5,18.25,700913,1725562
SD,2017,531,85339,0,26114,7463,112658,0,0,7994,224111,240988,148279,3861.2,16.3,248982,372390
TN,2017,3515,331613,11168,334567,1551,694516,332779,332779,349013,1693475,166376,182761,23849.4,17.51,515389,1876236
TX,2017,8735219,3987778,474274,1451978,7301999,6286229,403523,403523,16915015,12129508,810101,915338,125804.9,14.07,17725116,13044846
UT,2017,346868,231151,317768,274816,197089,294385,0,0,861725,800352,53257,64181,9262.3,16.92,914982,864533
VA,2017,121571,596648,343642,159813,40,847776,319562,319562,784815,1923799,140971,167010,28402.6,17.48,925786,2090809
VT,2017,0,12281,0,0,0,77379,0,0,0,89660,37782,40945,2582.4,21.5,37782,130605
WA,2017,0,350872,0,61732,0,769685,85013,85013,85013,1267302,949773,967707,23662.5,17.78,1034786,2235009
WI,2017,0,504808,0,388614,0,523110,100919,100919,100919,1517451,224149,198839,20531.1,16.74,325068,1716290
WV,2017,1836375,199298,2390309,710445,52102,191481,0,0,4278786,1101224,41626,49947,7477.9,17.61,4320412,1151171
WY,2017,1788258,158370,5516757,458496,433489,153755,0,0,7738504,770621,55888,59425,4407.1,14.51,7794392,830046
US,2017,33468883,28056891,15549225,13839632,19550489,36043829,8418968,8418968,76987565,86359320,11259473,11138359,1136379.4,17.32,88247038,97497679
AK,2018,375279,346255,13752,17325,997415,215613,0,0,1386446,579193,24147,24996,5834,22.2,1410593,604189
AL,2018,149607,771194,370533,377152,33591,518687,412584,412584,966315,2079617,279491,301170,21948.7,16.7,1245806,2380787
AR,2018,600455,366939,0,304145,28553,326432,132996,132996,762004,1130512,126101,124834,12447.8,16.45,888105,1255346
AZ,2018,44,400531,140759,331492,57,590247,325122,325122,465982,1647392,155979,179533,23684.9,23.98,621961,1826925
CA,2018,228906,2209801,0,33256,916715,3409954,190422,190422,1336043,5843433,1031998,1213958,137350.6,24.45,2368041,7057391
CO,2018,2217310,518088,293149,284474,965227,512429,0,0,3475686,1314991,156918,165952,18719.6,18.5,3632604,1480943
CT,2018,0,285991,0,4023,0,316551,176496,176496,176496,783061,37564,49572,14207.4,24.87,214060,832633
DC,2018,0,32623,0,37,0,19017,0,0,0,51677,1603,2661,2146.5,23.57,1603,54338
DE,2018,0,99416,0,4296,0,119451,0,0,0,223163,3388,8035,3896.7,20.74,3388,231198
FL,2018,1123,1511134,0,327807,10493,1843337,306461,306461,318077,3988739,246965,314801,64957.3,21.41,565042,4303540
GA,2018,0,759205,0,340152,0,998463,359262,359262,359262,2457082,288259,303573,37670.1,18.35,647521,2760655
HI,2018,0,192,0,14367,0,261466,0,0,0,276025,26286,31126,6828.7,30.36,26286,307151
IA,2018,0,431513,0,325673,0,418691,51181,51181,51181,1227058,865649,478666,15664.2,14.62,916830,1705724
ID,2018,2113,115833,0,2823,502,180666,0,0,2615,299322,178848,180196,6947.6,18.14,181463,479518
IL,2018,2596,1127424,1095887,704574,48045,1254095,1025651,1025651,2172179,4111744,359743,277668,45014.8,16.8,2531922,4389412
IN,2018,5292,890433,781628,985668,9609,703718,0,0,796529,2579819,271211,190075,29509.8,15.85,1067740,2769894
KS,2018,237402,321809,0,227665,198084,343686,95854,95854,531340,989014,253451,222816,12584.9,18.32,784791,1211830
KY,2018,96085,356673,955471,655909,12924,601468,0,0,1064480,1614050,90204,103816,19701.7,17.92,1154684,1717866
LA,2018,2942607,1865382,20436,137818,274384,1729715,179330,179330,3416757,3912245,172942,160945,32728.9,11.6,3589699,4073190
MA,2018,0,452093,0,101,0,576328,46437,46437,46437,1074959,75268,101071,27101.5,24.78,121705,1176030
MD,2018,14,312824,30464,124191,0,477626,156699,156699,187177,1071340,65935,90288,20383.8,22.08,253112,1161628
ME,2018,0,48370,0,2113,0,171062,0,0,0,221545,149399,155760,6140.9,20.16,149399,377305
MI,2018,95841,1010919,0,506105,31446,896217,318655,318655,445942,2731896,237119,247124,36285.8,17.46,683061,2979020
MN,2018,0,514172,0,261530,0,624491,152657,152657,152657,1552850,366361,296986,22766.6,17.39,519018,1849836
MO,2018,1,330552,5654,668188,548,619352,111401,111401,117604,1729493,131320,110649,23749.8,19.56,248924,1840142
MS,2018,36499,591886,31979,60015,96734,380952,72343,72343,237555,1105196,76637,74057,13102.2,17.96,314192,1179253
MT,2018,47712,90778,684031,152295,123027,171531,0,0,854770,414604,142936,147563,5088.3,18.56,997706,562167
NC,2018,0,599308,0,325121,0,906189,439915,439915,439915,2270533,248744,270114,35276.1,20.09,688659,2540647
ND,2018,993022,130084,399835,407262,2627248,190027,0,0,4020105,727373,209106,163255,6210.6,14.95,4229211,890628
NE,2018,459,196445,0,264072,11732,239157,58884,58884,71075,758558,359632,190495,9210.8,16.6,430707,949053
NH,2018,0,51471,0,7798,0,155704,105195,105195,105195,320168,56133,62624,5840.9,24.5,161328,382792
NJ,2018,0,799555,0,16732,0,888315,334373,334373,334373,2038975,48498,84239,32259.5,20.09,382871,2123214
NM,2018,1734539,281322,200179,136824,1421998,257803,0,0,3356716,675949,85193,95244,8261.1,19.91,3441909,771193
NV,2018,3,310875,0,34996,1455,308260,0,0,1458,654131,105590,117235,11142.3,20,107048,771366
NY,2018,10994,1393657,0,16710,1261,1423244,448718,448718,460973,3282329,442779,489219,62257.4,20.99,903752,3771548
OH,2018,2652291,1236747,219942,717818,129772,1089761,191483,191483,3193488,3235809,172886,158726,44050.3,17.43,3366374,3394535
OK,2018,3346437,842224,15121,171280,1148646,541278,0,0,4510204,1554782,308412,324177,17126.4,16.2,4818616,1878959
OR,2018,529,271311,0,16911,0,339590,0,0,529,627812,486729,502494,14229.4,20.26,487258,1130306
PA,2018,6632662,1515912,1278056,644056,36963,1170049,872749,872749,8820430,4202766,220435,251952,47961.5,18.96,9040865,4454718
RI,2018,0,104748,0,0,0,82615,0,0,0,187363,6661,10045,3873.6,24.84,6661,197408
SC,2018,0,338951,0,205204,0,526034,551151,551151,551151,1621340,147073,165199,20322,19.15,698224,1786539
SD,2018,494,95548,0,27618,7264,115313,0,0,7758,238479,253979,158194,4311.3,17.42,261737,396673
TN,2018,3737,404318,5922,251835,1198,700650,378224,378224,389081,1735027,186083,199132,26746.5,18.7,575164,1934159
TX,2018,9776991,4596600,328812,1189311,9200206,6720839,430597,430597,19736606,12937347,901007,1009917,148718.2,15.29,20637613,13947264
UT,2018,326320,253819,305328,273117,211790,310060,0,0,843438,836996,50329,61286,10437.1,18.46,893767,898282
VA,2018,117273,667004,318949,149349,29,869728,305826,305826,742077,1991907,159898,183826,32149.4,19.04,901975,2175733
VT,2018,0,14208,0,0,0,75792,0,0,0,90000,41541,44258,2834.8,23.11,41541,134258
WA,2018,0,334779,0,61166,0,775777,101502,101502,101502,1273224,938532,955305,25962.2,19.69,1040034,2228529
WI,2018,0,565291,0,362077,0,548839,105900,105900,105900,1582107,232070,203443,22826.7,17.5,337970,1785550
WV,2018,2159553,221402,2468639,661760,72689,216968,0,0,4700881,1100130,45396,53573,8767.1,18.79,4746277,1153703
WY,2018,1842525,175639,5315953,455748,501928,159048,0,0,7660406,790435,53833,54920,4962.3,15.41,7714239,845355
US,2018,37762229,31163246,15280478,13249958,22812423,36892286,8438068,8438068,84293198,89743558,11579533,11369899,1271930.6,18.61,95872731,101113457
AK,2019,364363,343384,14867,17620,968358,220818,0,0,1347588,581822,22744,23608,5689.3,21.36,1370332,605430
AL,2019,138425,748731,350506,317180,27687,529319,455865,455865,972483,2051095,278071,298545,21301.9,16.38,1250554,2349640
AR,2019,534585,371388,0,239798,27538,330550,141750,141750,703873,1083486,133487,132189,12055.8,16.07,837360,1215675
AZ,2019,68,484249,82222,257727,40,607131,333312,333312,415642,1682419,148099,174570,23601.3,23.3,563741,1856989
CA,2019,220789,2218732,0,30886,890882,3395439,168799,168799,1280470,5813856,1154051,1373488,139280.3,24.68,2434521,7187344
CO,2019,2394039,553842,270466,273338,1095372,526331,0,0,3759877,1353511,167007,178021,18788.9,17.77,3926884,1531532
CT,2019,0,293149,0,867,0,304773,174730,174730,174730,773519,37163,48862,13573.3,24.32,211893,822381
DC,2019,0,31603,0,5,0,18555,0,0,0,50163,2001,3049,2117.5,24.06,2001,53212
DE,2019,0,93442,0,2179,0,120332,0,0,0,215953,3609,8544,3789.4,19.87,3609,224497
FL,2019,1295,1578269,0,233542,11037,1804514,303946,303946,316278,3920271,248018,315365,62678.4,20.79,564296,4235636
GA,2019,0,786904,0,273109,0,995857,350759,350759,350759,2406629,301803,314211,36579.9,17.95,652562,2720840
HI,2019,0,228,0,14179,0,264338,0,0,0,278745,25256,29839,6731.5,29.48,25256,308584
IA,2019,0,433368,0,266368,0,430621,54671,54671,54671,1185028,901797,518892,14989.8,13.89,956468,1703920
ID,2019,1139,133257,0,2364,125,183278,0,0,1264,318899,169161,171550,6748.5,17.12,170425,490449
IL,2019,2279,1180447,1014448,591909,46969,1239327,1030996,1030996,2094692,4042679,372639,293917,42478.1,16,2467331,4336596
IN,2019,5306,934151,712235,821545,8997,710201,0,0,726538,2465897,257208,187427,28789.8,15.37,983746,2653324
KS,2019,212665,319950,0,197779,189208,352445,96565,96565,498438,966739,273904,239094,12004.6,17.31,772342,1205833
KY,2019,89339,361174,852990,574502,14273,595296,0,0,956602,1530972,89266,101676,18821,17.36,1045868,1632648
LA,2019,3330380,1963925,21251,90701,261401,1736963,145993,145993,3759025,3937582,166791,150526,29899.9,10.64,3925816,4088108
MA,2019,0,442794,0,71,0,572180,22734,22734,22734,1037779,74162,99536,25788.1,23.51,96896,1137315
MD,2019,14,311631,34661,77301,0,474069,156765,156765,191440,1019766,55532,79877,19482.1,21.44,246972,1099643
ME,2019,0,46301,0,2160,0,166761,0,0,0,215222,148418,154606,5874.4,19.27,148418,369828
MI,2019,90423,1054986,0,447823,29738,882063,343639,343639,463800,2728511,233639,244587,34773.9,16.89,697439,2973098
MN,2019,0,549487,0,205139,0,640082,147280,147280,147280,1541988,366083,298551,21981.8,16.59,513363,1840539
MO,2019,1,327798,4227,584662,484,622101,95961,95961,100673,1630522,140320,121475,22482.1,18.76,240993,1751997
MS,2019,34280,583800,28423,51028,96171,383081,115202,115202,274076,1133111,66399,70136,12526.6,17.35,340475,1203247
MT,2019,47967,92649,608890,159165,131037,175168,0,0,787894,426982,129142,133863,5016.8,17.99,917036,560845
NC,2019,0,569405,0,318154,0,905845,437683,437683,437683,2231087,253934,275441,34227.1,19.56,691617,2506528
ND,2019,1187235,157419,361946,372018,2949809,188349,0,0,4498990,717786,211309,164419,6006.9,14.67,4710299,882205
NE,2019,411,198771,0,240414,10883,242788,72589,72589,83883,754562,371883,203880,8895.7,16.03,455766,958442
NH,2019,0,55366,0,4182,0,152435,113890,113890,113890,325873,56006,62394,5545.5,23.52,169896,388267
NJ,2019,0,790685,0,13780,0,842885,278147,278147,278147,1925497,49338,84994,30396.5,19.88,327485,2010491
NM,2019,2068295,305538,268307,151468,1917576,262605,0,0,4254178,719611,94009,105040,7969.9,18.49,4348187,824651
NV,2019,5,315564,0,37177,1527,306466,0,0,1532,659207,113257,125022,11090.5,19.72,114789,784229
NY,2019,11313,1337750,0,13648,1561,1386269,468481,468481,481355,3206148,451961,498124,58489.7,20.16,933316,3704272
OH,2019,2901090,1260474,192413,594257,157179,1070162,177624,177624,3428306,3102517,174068,160334,41907.9,16.96,3602374,3262851
OK,2019,3545508,873688,5153,93953,1243885,524240,0,0,4794546,1491881,332122,347056,16164.2,15.54,5126668,1838937
OR,2019,420,302229,0,27430,0,334509,0,0,420,664168,426159,445620,14108.6,19.87,426579,1109788
PA,2019,7296205,1679486,1250902,568781,37362,1134520,869084,869084,9453553,4251871,201736,234570,45768.8,18.32,9655289,4486441
RI,2019,0,97931,0,0,0,77313,0,0,0,175244,8794,11832,3640.1,24.3,8794,187076
SC,2019,0,347904,0,160703,0,515839,585828,585828,585828,1610274,149819,166366,19712.4,18.84,735647,1776640
SD,2019,450,97428,0,31420,6644,116179,0,0,7094,245027,264610,169269,4163.8,16.63,271704,414296
TN,2019,3221,420285,11341,216876,1202,713625,372992,372992,388756,1723778,180964,191569,25954.4,18.3,569720,1915347
TX,2019,11323138,4795216,308449,992721,10622707,6850186,431234,431234,22685528,13069357,963037,1071087,137852.3,14.08,23648565,14140444
UT,2019,299544,276460,326024,266989,210444,305584,0,0,836012,849033,48197,60089,10037.6,17.46,884209,909122
VA,2019,111869,717725,320290,85120,34,872814,308013,308013,740206,1983672,142634,169910,31211.7,18.5,882840,2153582
VT,2019,0,14381,0,0,0,77367,0,0,0,91748,40984,43772,2735.5,22.16,40984,135520
WA,2019,0,378216,0,80837,0,794537,92584,92584,92584,1346174,784509,797587,25807.5,19.09,877093,2143761
WI,2019,0,592529,0,280108,0,547523,104736,104736,104736,1524896,232422,202897,21968.6,16.89,337158,1727793
WV,2019,2598072,239854,2422224,621722,98325,208371,0,0,5118621,1069947,41952,49681,8025.3,17.83,5160573,1119628
WY,2019,1684374,172235,4828513,410221,582375,155232,0,0,7095262,737688,63605,57094,4694.7,14.93,7158867,794782
US,2019,41658796,32236174,14290746,11314925,25612476,36867235,8451852,8451852,90013870,88870186,11627316,11468314,1223984.5,17.96,101641186,100338500
AK,2020,376458,373567,15523,18527,932482,222323,0,0,1324463,614417,24662,25527,4711.9,17.2,1349125,639944
AL,2020,124850,714871,313282,256687,24437,525878,454930,454930,917499,1952366,288430,308209,18583.2,14.85,1205929,2260575
AR,2020,489958,335441,0,161980,23578,315440,157349,157349,670885,970210,111501,118123,10368.4,14.79,782386,1088333
AZ,2020,68,513539,0,156821,28,544270,329597,329597,329693,1544227,151940,177618,20346.4,21.24,481633,1721845
CA,2020,192147,2151068,0,28034,809380,2688622,169838,169838,1171365,5037562,1027627,1244897,114531.6,23.65,2198992,6282459
CO,2020,2424701,552271,210494,217082,976775,437992,0,0,3611970,1207345,186014,194190,15470.4,16.47,3797984,1401535
CT,2020,0,297582,0,67,0,262428,164157,164157,164157,724234,37378,46777,11537.1,23.11,201535,771011
DC,2020,0,27984,0,0,0,15492,0,0,0,43476,2146,3024,1763.1,22.55,2146,46500
DE,2020,0,94009,0,1956,0,104587,0,0,0,200552,3570,7722,3153.6,18.42,3570,208274
FL,2020,1039,1619429,0,180387,8468,1484594,307315,307315,316822,3591725,258072,316100,51460.8,19.25,574894,3907825
GA,2020,0,779340,0,153179,0,875240,342897,342897,342897,2150656,313139,328340,31038.7,16.53,656036,2478996
HI,2020,0,199,0,13281,0,187858,0,0,0,201338,27938,31467,4695.2,30.08,27938,232805
IA,2020,0,396343,0,183017,0,404169,30344,30344,30344,1013873,899796,556341,12831.4,12.66,930140,1570214
ID,2020,112,129363,0,2663,6,175803,0,0,118,307829,151522,157879,5949.5,15.46,151640,465708
IL,2020,1951,1158640,689464,391150,40691,1056447,1047170,1047170,1779276,3653407,381142,297310,34108.8,14.44,2160418,3950717
IN,2020,4419,873505,450768,669310,7979,652153,0,0,463166,2194968,246927,182401,24272.9,14.16,710093,2377369
KS,2020,189060,301392,0,193779,160833,334609,110545,110545,460438,940325,299402,260617,10261.2,15.46,759840,1200942
KY,2020,81742,343788,571089,482266,12890,540200,0,0,665721,1366254,90287,100789,15413.1,15.48,756008,1467043
LA,2020,3311944,1924573,9438,48718,208843,1773653,177055,177055,3707280,3923999,167652,144854,24257.1,8.45,3874932,4068853
MA,2020,0,400675,0,0,0,449040,0,0,0,849715,73906,94678,20897.7,22.42,73906,944393
MD,2020,10,296585,27404,49692,0,397572,157531,157531,184945,901380,47200,66952,15950.4,19.98,232145,968332
ME,2020,0,47028,0,1657,0,157444,0,0,0,206129,132891,138648,4886,17.24,132891,344777
MI,2020,69860,1003430,0,334428,23515,756310,316854,316854,410229,2411022,224930,235184,29078.9,15.98,635159,2646206
MN,2020,0,496026,0,162702,0,545473,153319,153319,153319,1357520,351874,286430,17641.3,15.25,505193,1643950
MO,2020,1,303949,3432,551341,353,576090,80874,80874,84660,1512254,139952,117585,18885.1,16.89,224612,1629839
MS,2020,28956,610312,26576,54188,80619,369614,67595,67595,203746,1101709,64331,68741,10583,15.25,268077,1170450
MT,2020,42375,87478,469076,98886,108613,174592,0,0,620064,360956,137846,142312,4408.2,16.18,757910,503268
NC,2020,0,557570,0,223906,0,807695,442166,442166,442166,2031337,281029,293174,28743.1,17.77,723195,2324511
ND,2020,1212561,150166,364262,363255,2467413,163767,0,0,4044236,677188,228319,176757,4834.7,12.51,4272555,853945
NE,2020,375,192725,0,213747,9527,228175,64646,64646,74548,699293,342226,202857,7637,14.25,416774,902150
NH,2020,0,53630,0,1518,0,136963,103052,103052,103052,295163,45685,51219,4622.2,21.48,148737,346382
NJ,2020,0,678931,0,12144,0,686425,279308,279308,279308,1656808,51848,80762,24820.9,18.69,331156,1737570
NM,2020,2279119,292036,191349,138968,2136510,237384,0,0,4606978,668388,96377,106513,6778.6,16.92,4703355,774901
NV,2020,12,310715,0,27778,1115,245204,0,0,1127,583697,115194,125514,8774.8,17.93,116321,709211
NY,2020,10012,1305282,0,5681,837,1066114,401441,401441,412290,2778518,425899,468231,47971.5,19.41,838189,3246749
OH,2020,2612144,1233412,88255,556769,135810,982394,190316,190316,3026525,2962891,161047,151400,34985.2,15.29,3187572,3114291
OK,2020,3245209,847555,16,70714,985778,474552,0,0,4231003,1392821,323543,337045,13116.7,13.46,4554546,1729866
OR,2020,337,282518,0,17811,0,300473,0,0,337,600802,453244,473155,12070.6,18.06,453581,1073957
PA,2020,7564271,1783003,908798,374254,31483,949953,799342,799342,9303894,3906552,189068,217902,37536.6,17.08,9492962,4124454
RI,2020,0,100985,0,0,0,68314,0,0,0,169299,11414,13926,3140.3,23.05,11414,183225
SC,2020,0,343349,0,137280,0,465872,571930,571930,571930,1518431,160663,173989,16668.2,17.14,732593,1692420
SD,2020,439,91244,0,21692,5958,119687,0,0,6397,232623,261926,171078,3715.9,14.91,268323,403701
TN,2020,2866,398610,2377,176104,865,657467,383245,383245,389353,1615426,201950,211994,21402.6,16.15,591303,1827420
TX,2020,11464477,4718367,262510,872845,10090428,6187966,432869,432869,22250284,12212047,1058610,1149538,108367.3,11.94,23308894,13361585
UT,2020,265990,266595,296168,244280,176427,285122,0,0,738585,795997,50801,61965,8707.7,15.89,789386,857962
VA,2020,107908,748377,251899,75434,28,739500,314843,314843,674678,1878154,147175,170439,25579.5,16.69,821853,2048593
VT,2020,0,13589,0,0,0,70379,0,0,0,83968,37454,39823,2325.4,20.51,37454,123791
WA,2020,0,354969,0,59443,0,621358,98475,98475,98475,1134245,876201,884394,19941.1,17.58,974676,2018639
WI,2020,0,571817,0,249316,0,493092,102071,102071,102071,1416296,200885,183061,18492.5,15.48,302956,1599357
WV,2020,3123406,265123,1748361,539707,108465,179259,0,0,4980232,984089,41409,48020,6734.4,16.48,5021641,1032109
WY,2020,1490323,169076,3822600,388253,506818,138481,0,0,5819741,695810,74598,68407,3871.5,13.58,5894339,764217
US,2020,41632937,31562036,10723138,9182696,23573693,32333489,8251075,8251075,84180843,81329296,11682720,11518077,1007785.4,16.25,95863563,92847373
AK,2021,391866,384560,15838,18694,908255,256041,0,0,1315959,659295,24042,24907,6395.4,20.42,1340001,684202
AL,2021,115131,739546,238021,309791,24404,580020,480897,480897,858453,2110254,281006,303213,24223.6,17.84,1139459,2413467
AR,2021,457456,360504,0,216123,23961,329239,141603,141603,623020,1047469,112447,114123,13615.5,18.43,735467,1161592
AZ,2021,237,484962,0,160299,34,606053,330406,330406,330677,1581720,168977,197117,25548.6,25.06,499654,1778837
CA,2021,160821,2172757,0,28244,765942,2969515,172123,172123,1098886,5342639,1053602,1334148,150204.2,28.43,2152488,6676787
CO,2021,2300856,526513,247898,252442,872977,489206,0,0,3421731,1268161,208074,216066,20474.2,20.61,3629805,1484227
CT,2021,0,306843,0,2880,0,287268,179844,179844,179844,776835,41796,51792,13730.1,25.85,221640,828627
DC,2021,0,28336,0,0,0,17525,0,0,0,45861,2425,3358,2085.6,25.68,2425,49219
DE,2021,0,87778,0,4542,0,113210,0,0,0,205530,3679,8136,3888,21.48,3679,213666
FL,2021,1177,1591156,0,200193,8478,1750506,293097,293097,302752,3834952,287667,353523,66763.4,22.52,590419,4188475
GA,2021,0,773889,0,203870,0,922614,354662,354662,354662,2255035,316389,332568,38649.9,19.77,671051,2587603
HI,2021,0,133,0,12566,0,222977,0,0,0,235676,31415,35105,6346.8,32.69,31415,270781
IA,2021,0,383424,0,264419,0,411463,0,0,0,1059306,958793,599196,16773.2,16.41,958793,1658502
ID,2021,1387,135178,0,3051,142,188712,0,0,1529,326941,139389,145902,7725.1,19.29,140918,472843
IL,2021,2245,1082481,800378,521615,40154,1140285,1013204,1013204,1855981,3757585,418469,335451,45112.9,18.38,2274450,4093036
IN,2021,4291,870075,440100,753557,8666,714790,0,0,453057,2338422,289093,212543,31140.4,17.11,742150,2550965
KS,2021,178222,292156,0,219031,158779,338260,89572,89572,426573,939019,316241,276717,12668.1,19.05,742814,1215736
KY,2021,86378,365718,623427,548443,14020,585943,0,0,723825,1500104,90551,102456,20477.7,19.24,814376,1602560
LA,2021,3539624,1861540,4237,95856,197551,1840317,180180,180180,3921592,3977893,183666,144874,36273.4,12.46,4105258,4122767
MA,2021,0,404324,0,0,0,502317,0,0,0,906641,80220,103215,25412,25.72,80220,1009856
MD,2021,5,302243,30088,69186,0,433109,156623,156623,186716,961161,51493,73820,19827.3,23.58,238209,1034981
ME,2021,0,57233,0,1588,0,164149,0,0,0,222970,126936,133128,6031.7,21.03,126936,356098
MI,2021,77669,950120,0,436203,24689,816074,358698,358698,461056,2561095,236004,247406,36781.8,19.37,697060,2808501
MN,2021,0,523812,0,179055,0,567228,147526,147526,147526,1417621,372690,297813,22679.7,18.75,520216,1715434
MO,2021,0,293874,939,616413,341,609448,44839,44839,46119,1564574,164512,144808,23826.5,20.46,210631,1709382
MS,2021,28373,576923,33251,64446,76439,385435,122971,122971,261034,1149775,63750,68941,13633.2,18.94,324784,1218716
MT,2021,42842,86998,511753,122765,108076,176856,0,0,662671,386619,130110,134741,5626.3,20.51,792781,521360
NC,2021,0,637553,0,222501,0,884691,450408,450408,450408,2195153,275963,288212,36319.7,20.98,726371,2483365
ND,2021,1386928,190784,362308,361811,2305178,169566,0,0,4054414,722161,255260,185516,6175.1,15.68,4309674,907677
NE,2021,348,191008,0,216298,9707,237542,71875,71875,81930,716723,375590,217397,9665.8,17.53,457520,934120
NH,2021,0,60116,0,3259,0,141670,102957,102957,102957,308002,44756,50415,5660.4,25.65,147713,358417
NJ,2021,0,697019,0,12586,0,750887,293972,293972,293972,1754464,53898,85852,30993.9,21.8,347870,1840316
NM,2021,2603003,284989,172666,133228,2601468,262264,0,0,5377137,680481,127798,138630,9172.2,21.38,5504935,819111
NV,2021,4,305212,0,35910,1240,284865,0,0,1244,625987,128422,139948,11275.6,21.11,129666,765935
NY,2021,10019,1361190,0,5370,836,1209837,325671,325671,336526,2902068,424564,473907,59524.8,22.52,761090,3375975
OH,2021,2508664,1293129,68008,575920,106335,1029340,182628,182628,2865635,3081017,176348,165301,44522,18.49,3041983,3246318
OK,2021,3020469,745038,11,131695,813966,519226,0,0,3834446,1395959,352449,367146,17859.2,17.51,4186895,1763105
OR,2021,216,305665,0,1303,0,322320,0,0,216,629288,428108,449244,15233.9,21.4,428324,1078532
PA,2021,8057540,1867361,1070658,485193,35580,1035606,792878,792878,9956656,4181038,194203,223410,46423.2,19.49,10150859,4404448
RI,2021,0,105473,0,0,0,76590,0,0,0,182063,11872,14546,3736.6,25.66,11872,196609
SC,2021,0,350088,0,162628,0,509517,561696,561696,561696,1583929,154382,170674,21008.8,20.22,716078,1754603
SD,2021,174,96787,0,21589,5849,119919,0,0,6023,238295,308012,205338,4775.9,18.85,314035,443633
TN,2021,3738,413619,0,225784,893,715602,369061,369061,373692,1724066,187194,198765,27981.4,19.57,560886,1922831
TX,2021,12097844,4736878,229766,968401,9898665,6802215,420047,420047,22646322,12927541,1197430,1293066,161664.5,16.53,23843752,14220607
UT,2021,264055,274376,275199,276159,201927,302537,0,0,741181,853072,57198,67954,11113.6,19.68,798379,921026
VA,2021,101049,699927,283564,68603,28,789358,298458,298458,683099,1856346,162863,189262,32132.2,19.73,845962,2045608
VT,2021,0,13801,0,0,0,72373,0,0,0,86174,37726,40260,2813.5,24.24,37726,126434
WA,2021,0,382807,0,36943,0,712349,88909,88909,88909,1221008,842047,850547,25940.3,20.92,930956,2071555
WI,2021,0,559535,0,286760,0,533212,104149,104149,104149,1483656,200714,178716,23910.9,19.44,304863,1662372
WV,2021,3306066,279133,2045481,633582,103791,205121,0,0,5455338,1117836,41337,48756,8754.1,19.6,5496675,1166592
WY,2021,1255606,161354,4189040,376971,486091,146812,0,0,5930737,685137,101217,91943,5015.9,17.32,6031954,777080
US,2021,42914551,31655918,11642632,10547764,23372153,35251979,8128952,8128952,86058288,85584613,12303043,12139977,1317098.4,19.99,98361331,97724590
